NJ {
	1. 100 §{
		11.9. {
			Auf Bild A sehe ich → Na obrázku A vidím
			Auf dem ersten Bild gibt es → Na prvním obrázku je
			der Imbissstand → stánek rychlého občerstvení
			das Tablett → tác
			Das riecht echt gut. → To voní fakt dobře.
			Kartoffeln schälen → loupat/škrabat brambory
			den Tisch decken → prostřít stůl
			Ich habe gleich einen Termin. → Mám hned schůzku.
			einmal in Monat → jednou měsíčně
			jeden Tag kochen → každý den vařit
			meistens → většinou
			die Kantine → jídelna
			die Currywurst → Kašpárek
			das Tischdecken → prostírání na stůl
		}
		12.9. {
			die Pfanne → pánev
			das Sieb → síto
			die Zweibeln schneiden → krájet cibule
			das Gemüse waschen → umývat zeleninu
			der Topf → hrnec
			das Messer → nůž
			die Teilnehmer begrüßen → přivítat účastníky
			das Kochbuch → kuchařka
			das Gericht → pokrm
			Möchtest du das probieren? → Chceš to ochutnat?
			Das ist lecker. → To je chutné.
			mit meinem Bruder → s mým bratrem
			bei seiner Schwester → u jeho sestry
			Rezepte aus den Kochbüchern → recepty z kuchařek
			in deiner Küche → ve tvé kuchyni
		}
		14.9. {
			Ich habe Lust auf das Fleisch dort. → Mám chuť na to maso támhle.
			Macht dir der Kurs Spaß? → Baví tě ten kurz?
			Isst du nie Fisch? → Nikdy nejíš ryby?
			Wir gehen nachher dort aus? → Jdeme tam potom?
			Es sieht komisch aus. → To vypadá divně.
			süß → sladký
			sauer → kyselý
			scharf → ostrý \ pálivý
			fett → mastný
			salzig → slaný
			bitter → hořký
			das Schweinefleisch → vepřové
			das Rindfleisch → hovězí
			die Beilage → příloha
			beliebt → oblíbený
			die Döner-Bude → kebabárna
			Brot zum Frühstück essen → jíst chléb k snídani
			das Vollkornbrot → celozrnný chléb
			die Brezel → preclík
			das Öl → olej
			verschiedene Brotsorten → různé druhy chleba
		}
		18.9. {
			der/das Sandwich → sendvič
			der Schokoriegel → čokoládová tyčinka
			der Keks → sušenka
			der Kakao → kakao
			der Pfirsich → broskev
			der Erdbeere → jahoda
			die Preiselbeere → brusinka
			die Himbeere → malina
			die Johannisbeere → rybíz
			die Wurst → uzenina
			das Wurstchen → párek
			das Hühnerfleisch → kuřecí
			die Salzkartoffeln → vařené brambory
			die Rühreier → míchaná vajíčka
			das Spiegelei → volské oko
			der Pilz → hřib \ houba
			die Erbsen → hrášek
			die Meeresfrüchten → mořské plody
		}
		21.9. {
			Der Topf liegt auf dem Tisch. → Hrnec leží na stole.
			Neben den Tellern steht die Gläser. → Vedle talířů stojí skleničky.
			Sehen Sie sich die Fotos an. → Podívejte se na ty fotky.
			Was ist hier los? → Co se tady děje?
			Ich muss mich schnell umziehen. → Musím se rychle převléknout.
			Freust du dich schon? → Už se tešíš?
			Er beeilt sich so? → On tak pospíchá?
			Wir ärgern uns nicht oft? → Nerozčilujeme se často?
			Setzt euch aufs Sofa. → Sedněte si na pohovku.
			Sie regen sich immer auf. → Pořád se rozčilují.
			Na, alles klar bei dir? → Čau, jak je?
			nix/nichts → nic
			Kopf hoch. → Hlavu vzhůru.
			sich langweilen → nudit se
			sich treffen → potkat se
			die Bohnen → fazole
			den Fernseher anmachen → zapnout televizi
			Ich bin schon unterwegs. → Už jsem na cestě.
			Er schaut auf die Uhr. → Dívá se na hodinky.
		}
		25.9. {
			Hast du schon Geschirr gespült? → Už jsi umyl nádobí?
			Ich putze dreimal pro Woche. → Čistím třikrát týdně.
			Ich habe mich ausgeruht. → Odpočinul jsem si.
			Sie hat noch nicht eingekauft. → Ješte nenakoupila.
			Hast du den Film schon gesehen? → Už jsi viděl ten film?
			Warum hast du dich nicht gemeldet? → Proč jsi se neozval?
			wahrscheinlich → pravděpodobně
			eigentlich → vlastně
			Er hat mich zum Essen eingeladen. → Pozval mě na jídlo.
			Wir haben das Zimmer schnell aufgeräumt. → Pokoj jsme rychle uklidili.
			mit der Straßenbahn fahren → jet tramvají
		}
	}
	2. 100 §{
		5.10. {
			Ich habe ihn vor drei Tagen gesehen. → Viděl jsem ho před třemi dny.
			Ich habe mit ihr vor zwei Monaten gesprochen. → Mluvil jsem s ní před dvěma měsíci.
			Vor einem Monat war ich in Frankreich. → Před měsícem jsem byl ve Francii.
			zu Fuß gehen → jít pěšky
			mit der U-Bahn zur Schule fahren → metrem jet do školy
			mit dem Bus fahren → jezdit autobusem
			das letzte Mal → naposled
		}
		9.10. {
			die Cafeteria → bufet
			der Rinderbraten → hovězí pečeně
			der Streuselkuchen → drobenkový koláč
			der/das Streusel → drobenka
			der Gemüseauflauf → zeleninový nákyp
			der Lachs → losos
			die Torte → dort
			die Forelle → pstruh
			die Lasagne → lazaně
			die Tomatensosse → rajčatová omáčka
			das Dessert → dezert
			das Putenschnitzel → krůtí řízek
			das Apfelmark → jablečná přesnídávka
			die Bratkartoffeln → pečené brambory
			das Häpchen → chuťovka/jednohubka
			die Frikadelle → karbanátek
			die Maronen → pečené kaštany
			aussehen → vypadat
		}
		10.10. {
			der Nebensatz → vedlejší věta
			der Hauptsatz → hlavní věta
			die Geschichte → příběh \ dějepis
			ergänzen → doplnit
			traurig → smutný
			zum Abendessen kommen → přijít na večeři
			das Verb → sloveso
			das Subjekt → podmět
			am Ende → na konci
			das USB-Stick → fleška
		}
		16.10. {
			Ich wollte mit ihr nicht chatten. → Nechtěl jsem si s ní chatovat.
			keine Lust haben → nemít chuť
			keinen Durst haben → nemít žízeň
			müde sein → být unavený
			Das macht keinen Spaß. → To není zábava.
			Ich habe keinen Stift. → Nemám tužku.
			Sie haben keine Zeit. → Nemají čas.
			Zu Hause haben wir kein WLAN. → Doma nemáme Wi-Fi.
			Ich möchte keinen Film sehen. → Nechci vidět žádný film.
			Warum haben sie sich verspätet? → Proč se opozdili?
			sich streiten → hádat se
			Mein Fuß tut mir noch weh. → Bolí mě noha.
			Der Kühlschrank ist leer. → Lednička je prázdná.
			Das ist mir jetzt echt peinlich. → To je mi teď fakt trapné.
			Was ist los? → Co se děje?
		}
		2.11. {
			der Gedanke → myšlenka
			das Licht → světlo
			dunkel → tma \ tmavý
			ganz/total/völig → zcela/úplně
			eigen → vlastní
			die Ehrfahrung → zkušenost
			das Geräusch → zvuk
			der Geruch → vůně/pach
			zählen → počítat
			fühlen → cítit
			das Erlebnis → zážitek
			bestellen → objednat
			der Vorraum → předsíň
			verschieden → různý
			das Menü → meny/meníčko
			wählen → vybrat
			erkennen → rozpoznat
			der Kellner → číšník
			führen → vést
			blind → slepý
			behindert → postižený
			das Praktikum → stáž
			der Knoblauch → česnek
			die Linse → čočka
			das Kartoffelpüree → bramborová kaše
			das Brathähnchen → pečené kuře
			der/das Rindergulasch → hovězí guláš
			der Vanille → vanilka
			der Apfelstrudel → jablečný štrůdl
			der/die/das Spezi → kola s fantou
		}
		13.11. {
			Was darf's denn sein? → Co si dáte?
			Was nehmen Sie zum Essen? → Co si dáte k jídlu?
			Was möchten Sie zum trinken? → Co chcete k pití?
			Ich hätte gern... → Dám si rád...
			Zahlen Sie zusammen oder getrennt? → Zaplatíte dohromady, nebo zvlášť?
			Das macht 15 euro. → Stojí to 15 euro.
			Das stimmt so. → To si nechte.
			im Hotel arbeiten → pracovat v hotelu
			Er mag Bea. → Má rád Beu.
			die Chefin → šéfová
			zur Schule gehen → jít/chodit do školy
			Was gibt es heute? → Co bude dnes k jídlu?
			das Hühnchen → kuře
			das Filet → plátek
			Paprika in Würfel schneiden → paprika nakrájená na kostičky
			indisch essen → jíst indickou kuchyni
			Ich mach auf. → Otevřu.
			der Löffel → lžička
			die Serwiette → ubrousek
			die Dunkelheit → tma
			sich angewöhnen → zvyknout si na
			das Getränk → nápoj
			überhaupt → vůbec
			leer → prázdný
			benutzen → používat
			auf die Toilette gehen → jít na záchod
			die Sorge → starost
			in der Nähu → v blízkosti
			verboten → zakázaný
			bezahlen → zaplatit
		}
	}
	3. 100 §{
		14.11. {
			schwanger → těhotná
			Ich habe ein Hemd an. → Mám na sobě košili.
			Sie hat ein Kleid an. → Má na sobě šaty.
			schmutzig → špinavý
			das Abi/Abitur → maturita
			die Ausbildung → vyučení se
			der Altenpfleger → pečovatel o staré
			der Verkäufer → prodavač
			das Sportgeschäft → sportovní obchod
			im Krankenhaus arbeiten → pracovat v nemocnici
			reisen → cestovat
			nach der Schule → po škole
			der Schmuck → šperk
		}
		20.11. {
			das Heft → sešit
			der Kuli → propiska
			die Schere → nůžky
			der Bleistift → tužka
			der Laptop → počítač/laptop
			die Kopfhörer → sluchátka
			das Mikrofon → mikrofon
			zum Zahnarzt gehen → jít k zubaři
			Fühlst du dich schlecht? → Je ti špatně?
			Ich helfe meiner Mutter. → Pomáhám mámě.
			Kopfschmerzen haben → mít bolesti hlavy
			die Schulkantine → školní jídelna
			die Eingangshalle → vstupní hala
			die Sitzbank → lavička
			der Lift/Fahrstuhl/Aufzug → výtah
			das Chemielabor → laboratoř chemie
			das Schulleiterbüro → ředitelna
			das Büfett → bufet
			die Sporthalle → tělocvična
			die Garderobe → šatna
			der Steckbrief → vizitka
		}
		21.11. {
			ich will → chci
			erwachsen → dospělý
			Jetzt sehe ich das ganz anders. → Teď to vidím úplně jinak.
			Sport macht mir Spaß. → Sport mě baví.
			der Riesenspaß → obrovská sranda
			die Hauptsache → hlavní věc
			der Arme → chudák
			die Arme → chudačka
			ich soll → mám povinnost
			ich muss → musím
			fast jeden Tag → skoro každý den
			sie ist sauer → je naštvaná
			um sechs aufstehen → vstávat v šest
			auf dem Land wohnen → bydlet na venkově
			ich kann → umím/můžu
			ich darf → smím
			meistens → většinou
			Ich erinnere mich gern auf die Schule. → Rád vzpomínám na školu.
			der Unterricht → vyučování
			die Erinnerung → vzpomínka
			die Seife → mýdlo
			einreifen → natřít
			vor dem Abitur → před maturitou
			die Zeitung → noviny
			Ich konnte ausschlafen. → Mohl jsem vyspávat.
			das Fest → oslava
			zukleben → přilepit
			lustig → veselý
		}
		27.11. {
			die Geschichte → příběh \ dějiny
			Konntest du mit 6 Jahren schwimmen? → Uměl jsi v 6 letech plavat?
			Sangerin werden → stát se zpěvačkou
			am Computer spielen → hrát na počítači
			die Schule schwänzen → chodit za školu
			Echt? → Fakt?
			Ach, komm. → Ale, jdi ty!
			Das überrascht mich. → To mě překvapuje.
			Das wundert mich. → To mě udivuje.
			Das war bei mir auch so. → U mě to bylo stejné.
			Das ist bei mir nicht so. → U mě to je jinak.
			Das kenne ich gut. → To dobře znám.
			Das kann ich gut verstehen. → Tomu dobře rozumím.
			das Zeugnis → vysvědčení
			in die Berufschule gehen → chodit na učňák
			Das gefällt mir gut. → To se mi líbí.
			In einen halben Jahr bin ich fertig. → Za půl roku jsem hotov.
			jobben → brigádničit
			Die Ausbildung dauert drei Jahre. → Vyučení trvá tři roky.
		}
	}
	4. 100 §{
		4.12. {
			Wie gefällt dir der Laptop? → Jak se ti líbí ten počítač?
			Wie gefallen dir die Jeans? → Jak se ti líbí ty džíny?
			Ich finde den Schreibtisch praktisch. → Ten psací stůl mi přijde praktický.
			altmodisch → staromódní
			die Jacke → bunda na zapínání
			die Pudelmütze → kulich
			der Mantel → kabát
			die Jeans → džíny
			die Krevette → krevety
			langweilig → nudný
			peinlich → trapný
			geil → skvělý
			krass → hustý
			bombig → bombový
			furchtbar → otřesný
			ekelhaft → nechutný
		}
		5.12. {
			der Kalender → kalendář
			der Blumentopf → květináč
			der Blumenkasten → truhlík
			der Hocker → stolička
			das Spülbecken → umyvadlo
			das Mehl → mouka
			die Schublade → šuplík
			das Ladegerät → nabíječka na telefon
			die Zeitschrift → časopis
			die Pfeffermühle → pepřenka
			der Salzstreuer → slánka
			die Steckdose → zásuvka
			die Wohngemeinschaft → privát
		}
		7.12. {
			das Kissen → polštář
			die Vase → váza
			die Handtasche → kabelka
			das Regal → poličky/(skříň s poličkami)
			die Deckenleuchte → stropní osvětlení
			die Gardine → záclona
			die Kommode → komoda
			der Spiegel → zrcadlo
			der Betkasten → krabice pod postelí
			die Puppe → panenka
			die CD → CD
			der Tennisschläger → tenisová raketa
			der Zettel → lístek
			die Bettdecke → peřina
			der Wecker → budík
			die Schultasche → aktovka
			das Fernrohr → dalekohled
			der Nachttisch → noční stolek
			die Staffelei → stojan na obrazy
			die Matratze → matrace
			das Chaos → chaos
			der Deckel → víko/poklička/krytka
			die Klamotten → hadry/oblečení
			das Papiertaschentuch/Tempo → papírový kapesníček
			gemütlich → útulný
			kuschelig → mazlivý
			verrückt → šílený \ bláznivý
			bunt → pestrý/barevný
			protzig → okázalý/snobský
			stellen → postavit
			legen → položit
			hängen → pověsit
		}
		11.12. {
			Die Uhr hängt and der Wand. → Hodiny visí na stěně.
			Das Handy liegt auf dem Tisch. → Telefon leží na stole.
			Das Glas steht neben der Flasche. → Sklenice stojí vedle láhve.
			die Tür → dveře
			das Geschirrtuch → utěrka
			das Handtuch → ručník
			das Geschirrspülmittel/Spülmittel/Spüli → jar
			In der Küche ist alles wie immer. → V kuchyni je vše jako vždy.
			die Tasse → šálek
			der Becher → hrnek
			der Plastikbecher → kelímek
			der Boden → podlaha
			das Linoleum → lino
		}
		18.12. {
			das Weihnachtsgebäck → vánoční cukroví
			das Vanillekipferl → vanilkové rohlíčky
			der Stolleu → štola
			das Buttersplätzchen → linecké slepované cukroví
			die Schwedenbombe → indiánek
			der Spekulatius → spekulatius
			der Zimtstern → skořicová hvězdička
			das Spitzgebäck → linecké banánky
			der Lebkuchen → perník
			das Früchtebrot → ovocný chléb
			der Weihnachtszopf → vánočka
			zu Weihnachte → na Vánoce
			die Glocke → zvoneček
			der Weihnachtsbaum → vánoční stromeček
			der Karpfen → kapr
			am Heiligabend → na štědrý večer
			das Knoblauchaufstricl → česneková pomazánka
			Böller werfen → házet rachejtle
			belegte Brote → obložené chlebíčky
			der Weihnachtsmann → Ježíšek
		}
	}
	5. 100 §{
		8.1. {
			in den Ferien → o prázdninách
			sich entspannen → odpočinout si
			Seit einer Woche bin ich in Graz. → Již týden jsem ve Štýrském Hradci.
			eine Stadt kennen lernen → poznat město
			Ich freue mich über das Geschenk. → Těším se z dárku.
			Freust du dich auf die Sommerferien? → Těšíš se na letní prázdniny?
			Wohin kann man bei schönem Wetter gehen? → Kam se dá jít za lepšího počasí?
			das Museum → muzeum
			Meine Eltern kommen bald zu Besuch. → Moji rodiče brzy přijedou na návštěvu.
			Was kannst du mir empfehlen? → Co mi můžeš doporučit?
			das Viertel → čtvrť
			unbedingt → bezpodmínečně
			in der Sonne liegen → opalovat se
			Geld ausgeben → utrácet
			die Kunst → umění
			die Ausstellung → výstava
			enttäuscht → zklamaný
			außerdem → kromě toho
			Das Haus sieht von außen toll aus. → Ten dům vypadá zvenku skvěle.
			/einen Walzer tanzen → tancovat vals
			an der Uni/Universität → na univerzitě
			brauchen → potřebovat
			auf einen Ball gehen → jít na ples
		}
		9.1. {
			in den Park gehen → jít do parku
			im Park joggen → běhat v parku
			am Abend ins Restaurant gehen → večer jít do restaurace
			im Restaurant zu Mittag essen → obědvat v restauraci
			Gehst du oft ins Museum? → Chodíš často do muzea?
			Ich bin jetzt im Kino. → Jsem teď v kině.
			Willst du mit mir in den Club gehen? → Chceš se mnou jít do klubu?
			die Karlsbrücke → Karlův most
			die Prager Burg → Pražský Hrad
			das Nationaltheater → Národní divadlo
			der Wenzelplatz → Václavské náměstí
			die Pariser Straße → Pařížská ulice
			der Altstädter Ring → Staroměstské náměstí
			die Socke → ponožka
		}
		30.1. {
			Zeit verbringen → strávit čas
			die Grundschule → základní škola
			das Gymnasium → gymnásium
			eine Prüfung ablegen → složit zkoušku
			die Realschule → "reálná škola"
			die Hauptschule → "hlavní škola"
			studieren → studovat
			direkt → přímý
			Lehrer werden → stát se učitelem
			das Praktikum → stáž
			das Berufsleben kennen lernen → poznat pracovní život
			stressig → stresující
			Das hat mir gut gefallen. → To se mi hodně líbilo.
			das Fach → předmět
			In Physik hatte ich oft Probleme. → Ve fyzice jsem měl často problémy.
			die Fremdsprache → cizí jazyk
			die Vorbereitung auf → příprava na
			die Arbeitswelt → pracovní svět
			besonders wichtig → obzvlášť důležitý
			ein Projekt machen → dělat projekt
			der Hauptschulabschluss → závěrěčná zkouška "hlavní školy"
			die Ausbildung → vzdělání \ vyučení
			die Arzthelferin → zdravotní sestra
			Karriere machen → tvořit kariéru
			deshalb → proto
			jobben → brigádničit
			die Physioterapeutin → fyzioterapeutka
			sich für etwas entcheiden → rozhodnout se pro něco
			eine Arbeitstelle suchen → hledat si pracovní místo
			der Bankkaufmann → pracovník banky
			die Dauer → trvání
			der Schulabschluss → závěrečná zkouška na škole
			die Fachschule → odborná škola
			die Gesamtschule → obecná škola
		}
		5.2. {
			an der Grundschule → na základní škole
			am Gymnasium → na gymnásiu
			hassen → nenávidět
			schwierig → těžký
			in der Schulkantine essen → jíst ve školní jídelně
			die Sozialkunde → ZSV
			die Kundin → zákaznice
			der Kunde → zákazník
			früher → dříve
			die Note → známka
		}
		6.2. {
			die Schultasche → školní taška
			der Schulranzen → školní taška
			die/das Etui → penál
			der Schlüsselanhänger → přívěsek
			die Berge → hory
			der Stift → cokoli na psaní
			der Spickzettel → tahák
			die Boutique → obchod
			holen → dojít si pro něco
			leider → bohužel
			die Heimatstadt → rodné město
			Was hat dir nicht gefallen? → Co se ti nelíbilo?
			der Ordner → pořadač
			der Vertrag → smlouva
			Du hast dich gar nicht verandert. → Vůbec jsi se nezměnil.
			die Schleife → stužka
			Hauptsache, wir konnten die Lehrer ärgern. → Hlavně, že jsme mohli rozčilovat učitele.
			die Schauspielerin → herečka
			Das kommt drauf an. → To záleží.
			Warst du letzte Woche in den Bergen? → Byl jsi poslední týden na horách?
			Hier duzen sich alle. → Tady si všichni tykají.
		}
	}
	6. 100 §{
		8.2. {
			der Spitzer → ořezávátko
			spitz → ostrý
			der Flur → chodba
			die Kaffeemaschine → kávovar
			der Herd → sporák
			das Kleidergeschäft → obchod s oblečením
			die Bäckerei → pekárna
			das Zentrum → centrum
			weit → daleko
			der Berg → hora
			Sie hat im Zeugnis gute Noten gehabt. → Na vysvědčení měla dobré známky.
			gemeinsam → společně
			die Stelle → místo
			erzählen → vyprávět
			der Wunsch → přání
			ziehen → stěhovat se
			streng → přísný
			still → klidný
			unglücklich → nešťastný
			lächeln → usmívat se
			der Junge → kluk
			draußen → venku
			Gitarre spielen → hrát na kytaru
		}
		25.2. {
			Radio/Musik hören → poslouchat rádio/hudbu
			am Computer lernen → učit se na počítači
			(SMS schicken)/simsen → posílat si SMS
			herunterladen → stahovat
			das Ticket → lístek \ vstupenka
			die Datei anklicken → kliknout na soubor
			im Internet suchen → hledat na internetu
			die Datei → soubor
			Informationen recherchieren → hledat informace
			im Online-Netzwerk etwas posten → posílat něco na sociální sítě
			Videos im Internet ansehen → sledovat videa na internetu
			fernsehen → dívat se na televizi
			(der Fernseher)/(das Fernsehgerät) → televize/televizor
			der I-Pod → i-pod
			die Spielekonsole → hrací konzole
			der/das Tablet → tablet
			das E-Book → elektronická kniha
			chatten → chatovat
			skypen → skypovat
			twittern → twitterovat
			bloggen → blogovat
			im Alltag → v každodenním životě
			der Artikel → článek/člen
			die E-Mail → email
			Der Fernseher ist an\/aus. → Televize je zapnutá\/vypnutá.
			Das Fenster ist auf\/zu. → Okno je otevřené\/zavřené.
			oft/häufig → často
			E-Mails checken → pracovat s emaily
			benutzen → používat
			selten → zřídka
		}
		12.3. {
			das Betriebssystem → operační systém
			Bei Android sind die Apps besser als bei iOS. → Na androidu jsou lepší apky, než na iOS.
			zurzeit → v současnosti
			schwer → těžký
			die Speicherkarte → paměťová karta
			die Umfrage → anketa
			die Aussage → tvrzení \ výpověď
			vergleichen → srovnat/porovnat
		}
		1.3. {
			täglich → denně
			zocken → pařit
			die App/Applikation → aplikace
			Ich lade eine App herunter. → Stahuju apku.
			Lädst du die Datei herunter? → Stahuješ soubor?
			Er lädt Filme oft herunter. → Často stahuje filmy.
			viel teurer → mnohem dražší
			Auf dem Laptop kann man besser schreiben. → Na počítači se lépe píše.
			Dieser Bildschirm ist größer. → Tato obrazovka je větší.
			die DVD → DVD
			die CD → CD
			der Drucker → tiskárna
			die Tastatur → klávesnice
			der Lautsprecher → reproduktor
			die Webcam → webkamera
			die Maus → myš
			drucken → tisknout
			speichern → uložit
			das DVD-Laufwerk → mechanika
		}
		15.3. {
			Großbritannien → Velká Británie
			die Schweiz → Švýcarsko
			Norwegen → Norsko
			Polen → Polsko
			Irland → Irsko
			Frankreich → Francie
			die Slowakei → Slovensko
			Tschechien → Česko
			Spanien → Španělsko
			Japan → Japonsko
			die Niederlande → Nizozemí
			die Türkei → Turecko
			die Vereinigten Staaten von Amerika → USA
			China → Čína
			Ungarn → Maďarsko
			Portugal → Portugalsko
			Russland → Rusko
		}
	}
	7. 100 §{
		20.3. {
			das Thema → téma
			die Meinung → názor
			die Gefahr → nebezpečí
			für mich persönlich → pro mě osobně
			an diesem Ort → na tomto místě
			private Informationen ins Netz stellen → dávat soukromé informace na net
			fast immer → skoro pořád
			das Ding → věc
			aufpassen → dávat pozor
			überall → všude
			vorsichtig → opatrně
			der Vorteil → výhoda
			der Nachteil → nevýhoda
			Ich denke/finde/glaube/meine, dass... → Myslím si, že...
			Ich bin sicher, dass... → Jsem si jist, že...
			Ich bin froh, dass... → Jsem rád, že...
			Ich finde es wichtig, dass... → Považuji za důležité, že...
			nützlich → užitečný
			gefährlich → nebezpečný
			der Satz → věta
		}
		26.3. {
			Mein Name ist... → Moje jméno je...
			sich für den Unterricht vorbereiten → připravit se na vyučování
			schnell an Informationen kommen → rychle se dostat k informacím
			am Computer sitzen → sedět u počítače
			der Hörrer → posluchač
			die Hörrerin → posluchačka
			der Enkel → vnuk
			der Unsinn → nesmysl
			öfter Kontakt zu Freunden haben → mít častěji kontakt s přáteli
			Ich bin beruflich viel unterwegs. → Pracovně jsem hodně na cestách.
			einen Stadtplan ausdrucken → vytisknout plán města
			leben → žít
			die Werbung → reklama
			der Buchverlag → knižní nakladatelství
			Was machst du in deiner Freizeit? → Co dělás o svém volném čase?
			Was wolltest du als Kind werden? → Čím jsi se chtěl stát jako dítě?
			Ich lerne gern neue Menschen kennen. → Rád poznávám nové lidi.
			die Landschaft → krajina
			das Porträt → portrét
			Er hat sich zehn Minuten zu spät gekommen. → Zpozdil se o deset minut.
			das Stadion → stadion
			der Verein → klub
			die Lösung → řešení
		}
		27.3. {
			fett → tlustý
			dick → tlustý
			dünn → hubený
			schlank → štíhlý
			schön/hübsch → hezký
			unsympatisch → nesympatický
			dumm/doof → hloupý
			klung → chytrý
			unfreundlich → ne přátelský
			kahlköpfig → plešatý
			abgedreht/durchgeknallt → ujetý/vadný/pošahaný
			aufgetakelt → oháknutý
			abartig → úchylný
		}
		29.3. {
			Sie hat einen Schluckauf. → Má škytavku.
			Die Vatikanstadt hat die Fläche fon 440 Quadratmeter. → Vatikán má rozlohu 440 metrů čtverečních.
			Die Schweiz existiert seit 1291. → Švýcarsko existuje již od 1291.
			Das Macbook kostet bei Alza zirka 30000 tschechische Kronen. → Macbook stojí u Alzy cca 30000 Kč.
			der Rucksack → batoh
			wiegen → vážit
			der Radweg → cyklostezka
			Der Bildschirm hat 5 Zoll. → Obrazovka má 5 palců.
			der/die/das Dingsbums → "tamto"
		}
		2.4. {
			Was für Filme siehst du gern? → Co za filmy rád sleduješ?
			Siehst du Filme im Fernseher oder im Internet? → Díváš se na filmy na TV nebo na internetu?
			der Regisseur → režisér
			Bei welchen Film hast du viel gelacht oder geweint? → U kterého filmu jsi se hodně zasmál nebo zaplakal.
			Der Film ist ein Actionfilm. → Ten film je akční.
			die Komödie → komedie
			der Thriller → thriller
			die Romanze → romantický film
			der Fantasy-Film → fantazy
			In dem Film geht es um eine Familie aus der Türkei. → Ve filmu jde o jednu tureckou rodinu.
			in den sechziger Jahren → v šedesátých letech
			der Ausländer → cizinec
			der Gastarbeiter → levná pracovní síla
			fremd → cizí
			wenigstens → nejméně/alespoň
			die Heimatt → domovina/vlast
			überraschen → překvapit
			der Konflikt → konflikt
			die Versöhnung → usmíření se
			das Vorurteil → předsudek
			die Hälfte → polovina
			der Zuschauer → divák
			die Beschreibung → popis
			der Stern → hvězdička
		}
	}
	8. 100 §{
		3.4. {
			Ich finde den Film spannend. → Ten film přijde napínavý.
			empfehlenswert → hodný doporučení
			Manche Szene sind sehr lustig. → Hodně scén je zábavných.
			der Durchschnitt → průměr
			die Handlung → příběh
			das Ende → konec
			der Hauptdarsteller → hlavní představitel
			der Sportler → sportovec
			der Erfolg → úspěch
			am Anfang → na začátek
			begeistert → nadšený
			der Kaiser → císař
			die Kulisse → kulisy
			der Preis → cena
			bekannt → známý
			berühmt → slavný
			klasse → prvotřídní
			das Klischee → předsudek \ klišé
			der Maulwurf → krtek
			die Biene → včela
			umbringen → zabít
			der Mörder → vrah
			der Zauborer → kouzelník
			sterben → zemřít
		}
		17.4. {
			der Aussenseiter → outsider
			der Führerschein → řidičák
			schwul → teplý
			vulgär → sprostý
			die Autobahn → dálnice
			der Gott → bůh
			das Schwein → prase
			die Kuh → kráva
			die Wiese → louka
			der Bauer → statkář
			der Mais → kukuřice
			das Feld → pole
			der Schlauch → hadice
			klauen → šlohnout
			die Schwuchtel → buzna
			der Spasti → idiot
			stinken → smrdět
			abhauen → vypadnout
			das Benzin → benzin
			die Reihenfolge → pořadí
			wiederholen → opakovat
			der Nebel → mlha
			der Daumen → palec
			die Mautvignette → dálniční známka
			waagerecht → vodorovně
			Daumen runter → palec dolů
			das Straßenschild → dopravní značka
		}
		10.5. {
			ein Auto lenken/fahren → řídit auto
			schalten → řadit
			der Feikling → zbabělec
			beurteilen → posoudit
			das Holz → dřevo
			verletzt → zraněný
			Hast du sie noch alle? → Jsi normální?
			Gas geben → přidat plyn
			der Fuß → chodidlo
			im Vergleich zu → ve srovnání s
			das Bein → noha
			der Transporter → náklaďák
			überholen → předjet
			bekloppt → šílený \ magor
			das Blut → krev
			der Unfall → nehoda
			Ich stehe nicht auf Mädchen. → Nestojím o holky.
		}
		14.5. {
			Sprichst du über ihn? → Mluvíš na něj?
			die Vermutung → domněnka
			Störe ich? → Neruším?
			Komm rein. → Pojď dál.
			Videos drehen → natáčet videa
			Überleg doch mal. → Zapřemýšlej trochu.
			lacheln → smát se
			lächeln → usmívat se
			Was kann ich für Sie tun? → Co pro Vás mohu udělat?
			die Bewerbung → ucházení se o zaměstnání
			die Mappe → desky
			das Fotostudio → fotostudio
			der Ausdruck → výraz
			übermorgen → pozítří
			die Kundschaft → zákaznictvo
			Kopf nach oben. → Hlavu nahoru.
			Kopf zur Seite. → Hlavu na stranu.
			die Schulter → rameno
			das Auge → oko
		}
		15.5. {
			das Heim → domov/ústav
			Scheisse bannen → dělat vylomeniny
			der Arschloch → "zmetek" \ osina v zadku
			Ich bin nicht schuld. → Nejsem vinen.
			schlagen → bít
			das Gericht → soud
			der Schwachkopf → hlupák
			der Laster → náklaďák
			verprügeln → zmlátit
			der Kasten → bedna
			der Würfel → kostka
			die Figur → figura/figurka
			träumen → snít
			wirken → působit
		}
	}
	9. 100 §{
		17.5. {
			eine schlechte Note schreiben → napsat špatnou známku
			die Unterschrift → podpis
			unterschreiben → podepsat
			ankreuzen → zakroužkovat
			bei der Prüfung abschreiben → opisovat u zkoušky
			üben → cvičit
			Übung macht den Meister. → Cvičení dělá mistra.
			ausprobieren → zkusit \ vyzkoušet
			probieren → zkusit \ vyzkoušet
			die Tinte → inkoust
			austauschen → povyměňovat \ směnit
			die Augen verbinden → zavázat oči
			packen → zabalit/balit
		}
		29.5. {
			die Hochzeit → svatba
			die Geburt → narození
			der erste Platz → první místo
			das Jubiläum → výročí
			der Storch → čáp
			die Tüte → kornout/sáček/igelitka
			die Kleidung → oblečení
			der Blumenstrauss → kytice
			der Ring → prsten
			die Einladung zur Party → pozvánka na párty
			der Glückwunsch → blahopřání
			die Absage → odmítnutí \ zrušení
			das Brautpaar → svatební pár
			Alles Gute! → Vše nejlepší!
			Viel Glück! → Hodně štěstí!
			Herzlich Dank für... → Sdečné díky za...
			die Feier → oslava
			die Verlobten → snoubenci
			die Zukunft → budoucnost
			heiraten → vzít/oženit se
		}
		31.5. {
			Hartes Training lohnt sich doch. → Tvrdý trénink se přece vyplatí.
			am Vormittag → dopoledne (kdy)
			sich festlich umziehen → slavnostně se obléknout
			der Anzug → oblek
			das Kleid → šaty
			aufführen → uvést
			die Band → skupina
			versuchen → zkusit
			einen Maraton laufen → běžet maraton
			die Kirche → kostel
			in Urlaub fahren → odjet na dovolenou
			ungefähr 80 Leute → zhruba 80 lidí
			auf die Welt kommen → přijít na svět
			dekorieren → zdobit
			die Wäscheleine → šňůra na prádlo
			der Nachbar → soused
			die Freiheit → svoboda
			das Ereignis → událost
			die Großeltern → prarodiče
			unglaublich → neuvěřitelně
			erzählen → vyprávět
			die Einschulung → zápis do školy
			ein paar Leute → pár lidí
			ein Paar → pár
			der Direktor → ředitel
			Wäsche aufhängen → pověsit prádlo
			bedeuten → znamenat
			füllen → naplnit
		}
		5.6. {
			wegfahren → jet pryč
			die Achterbahn → horská dráha
			Das finde ich schade. → To mi přijde škoda.
			Ich bin auf sie böse. → Jsem na ni naštvaný/zlý.
			aufregend → vzrušující
			Wie geht's? - Geht so. → Jak je? - Jde to.
			gemeinsam → společně
			zusammen → společně
			bei Regen auf dem Sofa lesen → za deště si číst na pohovce
			in der Natur wandern → chodit na túry v přírodě
			die Prüfung bestehen → obstát u zkoušky
			vom Bahnhof abholen → vyzvednout z nádraží
			Gehen wir am Samstag zusammen aus? → Půjdeme v sobotu spolu ven?
		}
		7.6. {
			Regnet es? → Prší?
			Rufst du mich später an? → Zavoláš mi později?
			eine Fünf in Mathe schreiben → dostat pětku z matiky
			hoffen → doufat
			weltweit → celosvětově
			stattfinden → konat se
			segeln → plachtit
			der Fan → fanoušek
			die Spezialität → specialita
			das Schiff → loď
			der Hafen → přístav
			der Treffpunkt → shromaždiště/(místo setkání)
			das Festival → festival
			verschieden → různý
			sich abwechseln → obměňovat se
			Das ist ein Muss. → To je nutností.
			Bands geben Konzerte. → Skupiny dávají koncerty.
		}
		11.6. {
			Fotos auf seine Facebook Seite stellen → dávat fotky na svůj Facebook
			das Feuerwerk → ohňostroj
			Darf ich Ihnen meine Freundin vorstellen? → Smím Vám představit svou přítelkyni?
			das Team → tým
			leihen → půjčit
			genießen → užívat si
			die Sehenswürdigkeit → pamětihodnost
			das Brandenburger Tor → Braniborská brána
			das Reichstagsgebäude → budova říšského sněmu
			das Biergarten → pivní zahrádka
			die Kleinseite → malá strana
			die Serie → seriál
			gucken → podívat se
			sehen → podívat se
			schauen → podívat se
		}
	}
	10. 100 §{
		5.9. {
			an den Veranstaltungen teilnehmen → zúčastnit se akcí
			zahlreich → četný
			Ich probiere gern Spezialitäten. → Rád ochutnávám speciality.
			zusehen → přihlížet
			Du kannst die Stadt ansehen. → Můžeš si prohlédnout město.
			im Hafen Partys feiern → slavit párty v přístavu
			Ich mag die Atmosphäre von Festivals. → Mám rád atmosféru na festivalech.
			Magst du Rockkonzerte? → Máš rád rockové koncerty?
			eine Rundfahrt machen → podniknout okružní jízdu
			der Sportler → sportovec
			Leute auf der ganzen Welt → lidé po celém světě
			der Kumpel → kámoš
		}
		10.9. {
			verlieren → ztratit
			die Lautstärketaste → tlačítko hlasitosti
			die Handyhülle → kryt na telefon
			der Touchbildschirm/Touchscreen → dotyková obrazovka
			das Kabel → kabel
			den Akku/Akkumulator aufladen → dobít baterku
			die Lautstärke anpassen → upravit/přizpůsobit hlasitost
			das Handy entsperren → odemknout telefon
			der USB-Anschluss → USB koncovka/uzávěr/přípojka
			auf dem Touchscreen wischen oder tippen → přejíždět nebo klikat po dotykové obrazovce
			der Klingeton → vyzvánění
			der Fingerabdruck → otisk prstu
			der Daumen → palec
			löschen → smazat
			aushälten → vydržet
			speichern → uložit
			der Anbieter → operátor
			simsen → SMSkovat
			einreifen → zamrznout
			neustarten → resetovat
			mobile Daten → mobilní data
			das Betriebssystem → operační systém
			die Navi/Navigation → navigace
			die Freisprechenlage → handsfree
			der Browser → prohlížeč
			der Tarif → tarif
			eine große Rolle spielen → hrát velkou roli
		}
		11.9. {
			die Kirche → kostel
			hungrig → hladový
			der Tourist → turista
			shoppen gehen → jít nakupovat
			die Überraschung → překvapení
			der Hering → sleď
			die Speise → pokrm
			Einmal ist genug! → Jednou stačí/(je dost)!
			Das macht doch nichts. → To nevadí.
			nass → mokrý
			So ein Pech. → Taková smůla.
			Du, ich will dich etwas/was fragen. - Was gibt's? → Ty, chci se tě na něco zeptat. - Co je?
			Achte auf die richtige Form. → Pozor na správnou formu.
		}
		24.9.I {
			das Los → los
			gewinnen → vyhrát
			ärgerlich → zlostný
			gestresst → vystresovaný
			Es regnet. → Přsí.
			Ich komme gleich. → Hned přijdu.
			Wie schön. → Jak hezké.
			Da hast du aber Glück gehabt. → To jsi měl ale štěstí.
			Da freue ich mich total! → To se fakt těším.
			ein Los ziehen → setřít los
			die Laune → nálada
			auf den Teppich fallen → spadnout na koberec
			auf einer Party sein → být na párty
			jetzt → teď
			nun → teď
			Da is mir so unangenehm. → To je mi tak nepříjemné.
			Das tut mir schrecklich Leid. → To mě strašně mrzí.
			Ruf mich am Abend an. → Zavolej mi večer.
			Moin, Moin! → Čau, čau!
			Wie kann ich das wiedergutmachen? → Jak to mohu napravit?
			sauber → čistý
			wild → divoký
			weit → daleko
			nah → blízko
			am Ende → na konci
			am Anfang → na začátku
			melancholisch → melancholický
			originell → originální
			klasisch → klasický
			die Kindheit → dětství
			die Freundschaft → přátelství
			die Sehensucht → touha
			das Lied → píseň
		}
		24.9.II {
			der Morgenmuffel → spáč
			der Wecker klingelt → budík zvoní
			pennen → chrnět/chrápat
			Zähne putzen → čistit si zuby
			die Klamotten → hadry
			spicken → podvádět
			Ich habe (keinen Plan)/(keine Ahnung). → Nemám tušení.
			Alles fit im Schritt? → Všechno v pohodě?
			der Knutschfleck → cucflek
			verknallt → zabouchnutý
			knutschen → líbat/cucat se
			Händchen halten → držet se za ruce
			Darauf habe ich null Bock. → Nemám na to chuť.
			Franz/Französisch → francouzština
			pauken → šprtat
			kicken → kopat (do míče)
			die Streberin → šprtka
			abschreiben → opisovat
			löffeln → žrát \ hltat
			der Scheiterhaufen → žemlovka
			der Fraß → nechutné jídlo
			die Jungs → kluci
			der Waschbrettbauch → (pekáč buchet)/břišáky
			Ich bin im siebten Himmel. → Jsem v sedmém nebi.
			zu Bett gehen → jít do postele
			das Parfüm → parfém
			wegwerfen → vyhodit
		}
	}
	11. 100 §{
		25.9. {
			das Leben im Ausland → život v zahraničí/cizině
			zu zweit arbeiten → pracovat ve dvou
			Ich wollte schon lange ins Ausland. → Chtěl jsem už dlouho do zahraničí.
			Deutsch unterrichten → vyučovat němčinu
			pünktlich → dochvilný
			Da kann ich auch mitmachen. → To se mohu taky přidat.
			die Ankunft → příjezd
			überrascht → překvapený
			bestimmte Sachen → určité věci
			die Anmeldung → přihláška/přihlášení
			hilfsbereit → nápomocný
			nirgends → nikde
			ordentlich → pořádný/pořádně
			der Verkehr → provoz/styk
			Sie sind interessiert. → Mají zájem.
			die Überschrift → nadpis
		}
		1.10. {
			Auf welche Post wartet man ungeduldig? → Na jakou poštu se čeká netrpělivě?
			die Unterlagen → podklady
			die Bewerbung → ucházení se o zaměstnání
			erfolgreich → úspěšný
			wählen → vybrat \ zvolit
			Ihm kann man keine Geheimnisse anvertrauen. → Jemu se nedá svěřit žádné tajemství.
			Felix bekommt einen Anruf von seinem Freund Jens. → Felixovi zavolal jeho kamarád Jens.
			Wir fahren am Freitag los. → Vyjíždíme v pátek.
			Es ist noch ein Platz im Auto frei. → V autě je ještě jedno místo volné.
			Felix will unbedingt mitfahren. → Felix chce bezpodmínečně jet.
		}
		17.10. {
			der Hammer → kladivo/pecka
			bis zum nächsten Mal → napříště
			der Ärger → zlost/zloba
			der Vermieter → pronajímatel
			föhnen → fénovat
			die Tönung → tónování
			die Anwältin → advokátka
			der Anwalt → advokát
			der Tischler → truhlář
			der Grafiker → grafik
			die Schere → nůžky
			die Handbewerbung → pohyb rukama
			die Tätigkeit → činnost
			Was machen Sie beruflich? → Co je vaše zaměstnání?
			der Kamm → hřeben
		}
		5.11.I {
			Ich komme morgen zurück und dann melde ich mich. → Vrátím se zítra a pak se ozvu.
			Fahrkarten im Internet kaufen → nakupovat jízdenky na internetu
			Ich möchte eine Fahrkarte für die Hin- und Rückfahrt kaufen. → Chci si koupit jízdenku tam a zpět.
			Sie müssen in Mainz umsteigen. → Musíte přestoupit v Mainzu.
			Sie reservierten Plätze im Abteil. → Rezervovali jste si místa v kupé.
			Sie besitzen keine Bahncard. → Nevlastníte žádnou jízdní kartu.
			Eine Fahrkarte nach München, bitte. → Jednu jízdenku do Mnichova, prosím.
			Ich brauche eine Auskunft. → Potřebuji informaci.
			Wann fährt der nächste Zug nach Genf? → Kdy jede další vlak do Ženevy?
			Einfach\/Hin und zurück → jednosměrná\/zpáteční
			Muss ich umsteigen? → Musím přestupovat?
			Wann komme ich in Innsbruck an? → Kdy přijedu do Insbruku?
			Was kostet eine Fahrkarte nach Zürich? → Kolik stojí jízdenka do Curychu?
			Im Abteil\/Großraumwagen, bitte. → V kupé\/velkoprostorovém voze.
			Wann möchten Sie fahren? → Kdy byste chtěl(/a) jet?
			Der nächste Zug fährt um 12 Uhr von Gleis 3. → Další vlak jede ve 12 hodin z koleje 3.
			Möchten Sie erste oder zweite klasse fahren? → Chcete jet první nebo druhou třídou?
			Wo möchten Sie sitzen, am Gang oder am Fenster? → Kde chcete sedět, u uličky nebo u okna?
			der Tischler → truhlář
		}
		5.11.II {
			der Anwalt → advokát
			Mario interessiert sich für Sprach. → Mario se zajímá o jazyk.
			Die Arbeit soll nicht anstrengend sein. → Práce nemá být náročná.
			das Reisebüro → cestovní kancelář
			die Zugverbindung → vlakové spojení
			auf Geschäftsreise → na obchodní cestě
			der Fahrplan → jízdní řád
			der Schalter → přepážka
			ankommen → přijet
			die Ankunft → příjezd
			abfahren → odjet
			die Abfahrt → odjezd
			die Bahn → dráha
			der Waggon → vagón
			der Bahnsteig → nástupiště
			die Durchsage → hlášení
			das Gepäck → zavazadlo
			der Koffer → kufr
			das Schild → cedule
			der Passagier → pasažér
			der Schaffner → průvodčí
			Ein Mann kauft am Schalter eine Fahrkarte. → Nějaký muž kupuje u přepážky jízdenku.
		}
		6.11. {
			der Feierabend → padla
			die Anziegen auf der Stadt Homepage \[Sl. die Anzeige\] → inzeráty na domovské stránce města
			ein grossartiges Musikereignis → velkolepá hudební událost
			entspannte Atmosphäre → uvolněná atmosféra
			der Trainer → trenér
			erwarten → očekávat
			der Klassiker → klasika
			die Ermäßigung → sleva
			der Senior → senior
			vielseitig → rozličný
		}
	}
	12. 100 §{
		19.11. {
			die Kaputze → kapuca
			der Gürbel → pásek
			die Absatzshuhe → boty na podpatku
			der Hut → klobouk
			die Handshuhe → rukavice
			der Pulli/Pullover → svetřík
			der Ohrring → náušnice
			die Sonnenbrille → sluneční brýle
			das Oberteil → svršek
			der Rock → sukně
			die kurze Hose → kraťasy
			der Schal → šála
			das Armband → náramek
			der BH/Bustenhalter → podprsenka
			der Knopf → knoflík
			der Trainingsanzug → šusťáky
			ärmellos → bez rukávu
			gestreift → pruhovaný
			kariert → kostkovaný
			hellgrün → světle zelený
			dunkelgrün → tmavě zelený
		}
		28.11. {
			die Tätigkeit → činnost
			der Grund → důvod
			der Wechsel → změna
			die Möbel → nábytek
			der Werkstatt → dílna
			die Industrie → průmysl
			die Firma → firma
			der Elektrokonzern → nadnárodní společnost prodávající elektrotechniku
			die Tischlerei → truhlářství
			gestalten → tvořit
			arbeitslos → nezaměstnaný
			gründen → založit
			aufhören → přestat
			antik → antický/starobylý
			liebevoll → láskyplný
			der Schmuck → šperk
			das Spital → nemocnice
			das Herz → srdce
			der Chirurg → chirurg
			der Arztkittel → lékařský plášť
			der Oberarzt → primář
			sich einen Traum erfüllen → splnit si sen
			seine Entscheidung bereuen → litovat svého rozhodnutí
			die Freiheit → svoboda
			der Lasterwagen → náklaďák
			der Höhepunkt → vrchol hory
		}
		3.12. {
			der Streit → hádka
			der Liebeskummer → starosti v lásce
			kritisieren → kritizovat
			Ein Lehrer reitet auf mir herum. → Jeden učitel si na mě zasedl.
			mit dem linken Bein zuerst aufgestanden sein → vstát levou nohou
			Ich drehe völlig ab. → Totálně se rozčílím.
			die Fenster zuschlagen → zabouchnout okna
			Du bist/liegst total daneben. → Jsi úplně mimo.
			Die Erde bebt. → Země se třese.
			Ich ticke völlig aus. → Vyletím z kůže.
			verziehen/entschuldigen → prominout
			sich benehmen → chovat se
			die Mailbox → e-mailová schránka
			zurückrufen → zavolat zpět
			angepisst → hodně "naštvaný"
			Sie liefern mich an. → Odvezou mě.
			Ich bin total im Arsch. → Jsem totálně v prdeli.
			krepieren/sterben → chcípnout/zemřít
			kratzen → škrábat
			Ich smeiße mich vor dir auf die Knie. → Vrhám se před tebou na kolena.
			doof → hloupý
		}
		5.12. {
			Ich habe mich von meiner Freundin getrennt. → Rozešel jsem se se svou přítelkyní.
			Sie weint die ganzen Tage. → Brečí celé dny.
			Ich habe Streit mit meinem besten Freund, weil mir seine Freundin nicht gefällt. → Pohádal jsem se svým nejlepším kamarádem, protože se mi nelíbí jeho přítelkyně.
			Ich finde Max idiotisch. → Myslím si, že Max je idiot.
			Mir fehlt die Motivation. → Chybí mi motivace.
			Ich bin in sie verliebt. → Jsem do ní zamilovaný.
			Alle nerven mich. → Všichni mě iritují.
		}
		10.12.I {
			der Kern → jádro
			die Geschwister → sourozenci
			chaotisch → chaotický
			anstrengend → namáhavý
			rote Haare → zrzavé vlasy
			der Zwilling → dvojče
			die Sommersprosse → piha
			das Einzelkind → jedináček
			reden/sprechen → mluvit
			Sie sehen gleich aus. → Vypadají úplně stejně.
			das Bundesland → spolková země
			das Ferienhaus → chata
			im Norden von Deutschland → na severu Německa
			Sie lacht immer so albern. → Směje se vždy tak bláznivě.
			Sie geht mir auf (die Nerven)/(den Wecker/Keks/Sack). → Leze mi na nervy.
			Das ist so gemein. → To je tak sprosté/nezdvořilé.
			die schlechte Laune → špatná nálada
			das Badezimmer → koupelna
			das Schlaffzimmer → ložnice
			der Kamin → krb
			Um Himmels willen! → Pane Bože!
			die Badehose → plavací šortky
			der Badeanzug → jednodílné dámské plavky
			der Bikini → dvoudílné dámské plavky
			der Sand → písek
			die Angel → prut/udice
			angeln/(Fische fangen) → rybařit
			der Bootssteg → kotviště
			springen → skákat
		}
	}
	13. 100 §{
		10.12.II {
			der Eimer → kýbl/kbelík
			die Schaufel → lopatka
			ein leckeres Abendessen → chutná večeře
			der Wurm → červ
			der Haken → hák/háček
			rennen → běhat
			rein ins Wasser → vletět/šup do vody
			Mach Platz! → Uhni!
			Spinnst du? → Blázníš?
			Ich trau' mich nicht. → Netroufám si.
			Sie spritzen ihn mit Wasser nass. → Zlili ho vodou.
			Er gießt ihm einen Eimer Wasser über den Kopf. → Nalil mu kýbl vody na hlavu.
			Lass mich in Ruhe. → Nech mě na pokoji.
			Wasser über den Kopf → voda na hlavu
			erschrecken → vystrašit
			schleichen → plížit se
			sich verstecken → schovat se
			das Versteck → úkryt/schovka
			das Gespenst → strašidlo
			das Bettuch → prostěradlo
			die Arme weit ausstrecken → roztáhnout ruce
			kichern → chichotat se
			heuren → bulet/brečet
			flüstern → šeptat
			unter die Bettdecke kriechen → zalézt pod poeřinu
			Das gibt es doch nicht! → Tak tohle teda ne!
		}
		12.12. \[10.9. + 24.9.II + 5.11.I\] {
			das Verstecken → schovávaná
			in der Mitte des Sees → uprostřed jezera
			Er zieht seine Badehose an. → Obléká si plavky.
			eine wasserdichte Tasche → vodotěsná taška
			der Vogel → pták
			die Stimme → hlas
			Sie/Er liegt sich in den Sand. → Lehne si do písku.
			Er reisst die Augen auf. → Rozevře oči.
			in einem Boot sitzen → sedět ve člunu
			sich verstecken → schovat se
			Er will sie erschrecken. → Chce je vylekat/vystrašit.
			Er klettert auf den Baum. → Vyleze na strom.
			die Wiese → louka
			der Becher → hrnek/kelímek
			vorsichtig → opatrný
			klauen → čmajznout/šlohnout
			fressen → žrát
			der Flip-Flop → žabka
			der Dieb → zloděj
			verschvinden → zmizet
			der Langweiler → nudař/(nudný člověk)
			Plötzlich weht ein kalter Wind. → Najednou zavál studený vítr.
			In einer halben Stunde sind wir zu Hause. → Za půl hodiny jsme doma.
			sich ausziehen → svléknout se
			das Sweatshirt → mikina
			die Welle → vlna
			gefährlich → nebezpečný
			erschöpft → vyčerpaný
			das Holz → dřevo
			das Feuer → oheň
			das Abenteuer → dobrodružství
		}
		11.2.I {
			das Feriencamp → prázdninový tábor
			seufzen → vzychat/(povzdechnout si)
			zelten → stanovat
			seit einem halben Jahr → už půl roku
			der Gruppenleiter → vedoucí skupiny
			sich wohlfühlen → cítit se dobře
			Sie umarmt ihn. → Obejme ho.
			Sie setzt sich allein in eine Bank. → Sedla si sama na sedačku.
			einsteigen → nastoupit
			umsteigen → přestoupit
			aussteigen → vystoupit
			Sie setzt die Kopfhörer auf. → Nasadí si sluchátka.
			winken → mávat
			gefährlich → nebezpečný
			der Campingplatz → kemp
			das Kanu → kánoe
			ein Zelt aufbauen → postavit stan
			Sie hat Heimweh. → Stýská se jí po domově.
			der Zeltsack → obal na stan
			die Zeltstange → stanová tyč
			das Außenzelt → vnější plachta stanu
			das Innenzelt → vnitřní část stanu
			die Luftmatratze → nafukovací matrace
			die Luftpumpe → nafukovací pumpička
			die Sonnencreme → opalovací krém
			der Schlafsack → spacák
			schieben → posunout/zasunout
			ein seltsames Mädchen → divná holka
			Sie hat schlechte Laune. → Má špatnou náladu.
			die Bauchschmerzen → bolest břicha
		}
	}
	14. 100 §{
		11.2.II {
			das Labyrinth → bludiště
			der Felsen → skála
			die Höle → jeskyně
			die Hölle → peklo
			das Tal → údolí
			die Leiter → žebřík
			der Leiter → vedoucs
			die Leiterin → vedoucí (žena)
			der Quatsch → blbost
			Was ist los? → Co se děje?
			wütend → rozzuřený
			Er hat mit ihr Mitleid. → Má s ní soucit.
			anstrengend → namáhavý
			die Wiese → louka
			plötzlich → najednou
			schießen → střílet
			der Schuss → panna
			das Trikot → sportovní dres
			das Bein strecken → natáhnout nohu
			Das ist gemein! → To je ošklivé/sprosté!
			fließen → téci
			der Mond → měsíc
			die Taschenlampe → příruční svítilna
			Gute Besserung! → Brzy se uzdrav!
			unheimlich → strašidelný
			der Wind → vítr
			die Gestalt → postava
			der Waschraum → umývárna
			jemandem einen Streich spielen → udělat někomu kanadský žertík
			der Strumpf → podkolenka/punčocha
		}
		11.2.III {
			der Wasserhahn → kohoutek na vodu
			kuscheln → mazlit se
			eklig → hnusný \ odporný
			ekelhaft → hnusný \ odporný
			Sie zählt die Tage. → Odpočítává dny.
			Sie feiern ein Fest. → Slaví nějaký svátek.
			aufregend → vzrušující
			Sie ist erschrocken. → Je vylekaná/vystrašená.
			das Lagerfeuer → táborák
			das Gedicht → báseň
			der Nadelbaum → jehličnan
			der Vogel → pták
			das Nest → hnízdo
			der Kuckuck → kukačka
			der Rotmilan → luňák červený
			die Feder → pero/pírko
			der Kaugummi → žvýkačka
			das Halstuch → šátek
			das Gummibärchen → gumový medvídek
			Sie teilen ihre Sachen. → Rozdělují/Sdílejí si věci.
			Warum bist du immer so zickig? → Proč jsi pořád tak protivná?
			selten → zřídka
			aufgeregt → rozrušený
			Mir tut alles weh. → Všechno mě bolí.
			Ich habe mir den Fuß verstaucht. → Zvrtl jsem si kotník.
			stöchnen → vzdychat (bolestí)
			vorsichtig → opatrně/opatrný
			sich anziehen → obléknout se
			sich umziehen → převléknout se
			sich ausziehen → svléknout se
			der Eiswürfel → ledová kostka
			der Stock → hůl
			der Kuss → polibek
			Sie stossen an. → Připijí si.
		}
		11.2.IV {
			die Werkstatt → dílna
			das Telefongespräch → telefonní rozhovor
			nervös → nervózní
			sich vorbereiten → připravit se
			Das Gespräch verläuft dann besser. → Rozhovor pak probíhá lépe.
			das Radio ausschalten → vypnout rádio
			die Tür zumachen/schliessen → zavřít dveře
			sich konzentrieren → soustředit se
			Stift und Papier bereitlegen → předpřipravit něco na psaní a papír
			notieren → zapsat si
			klar und deutlich sprechen → mluvit jasně a zřetelně
			lächeln → usmívat se
			Sie ruft bei der Firma Thermo an. → Zavolá do firmy Thermo.
			Kann ich bitte mit Herrn Schulz sprechen? → Mohu prosím mluvit s panem Schulzem?
			Kann ich eine Nachricht für Herrn Stein hinterlassen? → Mohu zanechat zprávu pro pana Steina?
			Können Sie mich bitte mit Frau Schmidt verbinden? → Můžete mě prosím spojit s paní Schmidtovou?
			Können Sie mir bitte die Durchwahl geben? → Můžete mi prosím dát klapku?
			Frau Spatz ist gerade nicht am Platz. → Paní Spatz právě není na místě.
			Kann ich etwas ausrichten? → Mohu něco vyřídit?
			Können Sie später noch einmal anrufen? → Můžete znovu zavolat později?
			Möchten Sie eine Nachricht hinterlassen? → Chcete zanechat zprávu?
			Kann Frau Glinz Sie zurückrufen? → Může Vám paní Glinz zavolat zpět/později?
			der Chef → šéf
			die Chefin → šéfka
			der Koch → kuchař
			die Köchin → kuchařka
			kochen → vařit
			der Kocher → vařič
			der Kuchen → koláč
			die Küche → kuchyň
			der Job → práce
		}
	}
	15. 100 §{
		11.2.V {
			im Alter arbeiten → pracovat ve stáří
			Prost/(Zum Wohl)! → Na zdraví!
			(Guten Appetit)/Mahlzeit! → Dobrou chuť!
			Die Arbeitswelt verändert sich schnell. → Pracovní svět se rychle mění.
			die Fähigkeit → schopnost
			ein eigenes Büro haben → mít vlastní kancelář
			erreichbar → dosažitelný/zastižitelný/dostupný
			die richtige Balance zwischen Arbeit und Freizeit finden → najít rovnováhu mezi prací a volným časem
			die Internetverbindung → internetové připojení
			Starre Hierarchien sind unmodern. → Pevné/Zkostnatělé hierarchie jsou zastaralé.
			das Erlebnis → výsledek
			die Flexibilität → flexibilita
			der Vertrag → smlouva
			das Arbeitsverhältnis → pracovní poměr
			existieren → existovat
			die Sicherheit → jistota/bezpečí
			der Arbeitsalltag → každodenní/všední pracovní den
			selbstständig → samostatný
			Lebenslanges lernen ist besonders wichtig. → Celoživotní učení je obzvlášť důležité.
			erfolgreich → úspěšný
			die klassische Arbeits-teilung → klasické pracovní rozdělení
			Sie kümmert sich um die Familie. → Stará se o rodinu.
			Geld verdienen → vydělávat peníze
			die Reiseunterlagen → cestovní podklady
			Wann fährt er zurück? → Kdy přijede zpět?
			das Ziel → cíl
			die Rückfahrt → zpáteční jízda
			die Wegbeschreibung → popis cesty
			Auskunft geben → dát informaci
			das Souvenir → suvenýr
		}
		13.2. {
			Wie war dein letztes Wochenende? → Jaký byl tvůj poslední víkend?
			unter der Brücke → pod mostem
			eine Fahrradtour machen → udělat si vyjížďku na kole
			Das Wetter ist leider schlecht. → Počasí je bohužel špatné.
			die Möbel → nábytek
			eine Firma gründen → založit firmu
			der Fahrradbote → poslíček na kole
			der Empfänger → adresát
			die Verletzung → zranění
			der Architekt → architekt
			Südfrankreich → jižní Francie
			der Ausdruck → výraz
			die Buchhandlung → knihkupectví
			Auf Wiederhören. → Na slyšenou.
			der Austausch von Wissen → výměna informací
		}
		18.2. {
			der Notruf → tísňové volání
			Das schaffe ich locker. → V pohodě stíhám.
			das Foyer → předsálí
			Kommst du mit? - Ja, bin gern dabei. → Příjdeš? - Jo, určitě.
			pünktlich → dochvilný
			LG/(Liebe Grüse). → Srdečné pozdravy.
			nächster Halt → příští zastávka
			der Unfall → nehoda
			die Richtung → směr
			Die Nummer ist vorübergehend nicht erreichbar. → Číslo je dočasně nedostupné.
			Wo steckst du denn? → Kde trčíš/vězíš?
			Das Navi hat mir einen anderen Weg gesucht. → Navigace mi hledala jinou cestu.
			das Parkhaus → parkovací dům
			das Tor → brána
			die Panne → porucha
			einen Parkplatz suchen\/finden → hledat\/najít parkovací místo
			im Stau stehen → stát v koloně
			an der Ampfel stehen → stát na semaforu
			den Anschluss verpassen → zmeškat spoj
			Ich muss jetzt noch zur Tankstelle. → Musím ještě na pumpu.
			Alle Plätze sind besetzt. → Všechna místa jsou obsazena.
		}
		3.3. {
			Geht das überhaupt? → Jde to vůbec?
			Wir nehmen Ihnen die Sorgen ab. → Zbavíme Vás starostí.
			die Strecke → cesta/trasa
			die Baustelle → staveniště
			das Ziel eingeben → zadat cíl
			stressfrei → bez stresu
			übermorgen → pozítří
			das Gerät einschalten → zapnout přístroj
			die Radarkamera → radar
			rechtzeitig ankommen → přijít/přijet včas
			den nächsten Bus erreichen → stihnout další autobus
			Stell dir vor was Gestern passiert ist. → Představ si, co se včera stalo.
			auf dem Land/Lande wohnen → bydlet na venkově
			Am Anfang ist alles gut gegangen. → Na začátku šlo všechno dobře.
			Gibt es hier in der Nähe eine Tankstelle? → Je tu někde blízko pumpa?
			Bleibt sie das ganze Wochenende? → Zůstane celý víkend?
			Hat sie eine warme Jacke eingepäckt? → Sbalila si teplou bundu?
			das Kfz/Kraftfahrzeug → vozidlo
			der Abflug → odlet
			die Garage → garáž
			der Pkw/Personenkraftwagen → osobní automobil
			die Versicherung → pojištění
			das Kennzeichen → SPZ
			rückwärts fahren → jet pozpátku
			bremsen → brzdit
			die Reparatur → oprava
			landen → přistát
			tanken → tankovat
			die Viertelstunde → čtvrthodina
			Zum Glück ist niemand verletzt. → Naštěstí není nikdo zraněn.
			Der Flug dauert lange. → Ten let trvá dlouho.
		}
	}
	16. 100 §{
		13.3.I {
			besiegen → porazit
			heimlich → tajně
			die Stupsnase → pršák
			egoistisch → sebestředný
			Das gefällt ihnen gut. → To se jim hodně líbí.
			das Zimmer betreten \[prät.	hat betreten\] → vstoupit do pokoje
			der Kiosk \[pl.	-e\] → stánek
			der Eistee → ledový čaj
			sich an einen Tisch setzen → posadit se na stůl
			ein Theaterstück proben → zkoušet divadelní hru
			die Schulaula → školní aula
			Endlich ist die Schule aus. → Konečně skončila škola.
			die Bühne \[pl.	-n\] → jeviště
			die Sage \[pl.	-n\] → pověst
			das Ungeheuer \[pl.	-\] → nestvůra
			das Labyrinth \[pl.	-e\] → bludiště
			töten → zabít
			der Mut → odvaha
			Sie hebt die Hände hoch. → Zvedne ruce.
			der Scheinwerfer \[pl.	-\] → světlomet/reflektor
		}
		13.3.II {
			die Reihe \[pl.	-n\] → řada
			weitere Rollen verteilen → rozdělit další role
			Das Handy klingelt. → Zvoní mobil.
			Alle drehen sich um. → Všichni se otočí.
			Sie denkt kurz nach. → Krátce zapřemýšlí.
			Sie hat Herzklopfen. → Buší jí srdce.
			verwirrt → zmatený
			Er unterbricht ihn. → Přeruší ho.
			eingebildet → namyšlený/nafoukaný
			Er sieht ein bisschen verlegen aus. → Vypadá trochu rozpačitě.
			(an der Reihe)/dran sein → být na řadě
			Alle hören gespannt zu. → Všichni napjatě poslouchají.
			Alle können den Text längst auswendig. → Všichni umí text dávno nazpaměť.
			der Star \[pl.	-s\] → divadelní/filmová hvězda
			Ich habe Angst um dich. → Mám o tebe strach.
			der Daumen \[pl.	-\] → palec
			der Zeigefinger \[pl.	-\] → ukazováček
			der Mittelfinger \[pl.	-\] → prostředníček
			der Ringfinger \[pl.	-\] → prsteníček
			der kleine Finger → malíček
		}
		13.3.III {
			Er beugt sich zu ihr. → Nakloní se k ní.
			Man darf das nicht merken. → Člověk si toho nesmí všimnout.
			die Rolle übernehmen → převzít roli
			Sie ist erschrocken. → Je vyděšená.
			Sie kennt die Szene in- und auswendig. → Zná tu scénu (úplně nazpaměť)/(i pozpátku).
			Er räuspert sich. → Odkašle si.
			Ich habe Gänsehaut. → Mám husí kůži.
			Sie ist ganz außer Atem. → Sotva popadá dech (šokem).
			Sie wird von Wut rot. → Zrudla vztekem.
			Er zwinkert ihm zu. → Mrkne na něj.
			Wenn es sein muss! → Když to teda musí být!
			Das hat keinen Sinn. → To nemá smysl.
			Ihr Augen funkeln ihn böse an. → Jiskří na něj zle svýma očima.
			auf dem Heimweg → cestou domů \ na cestě domů
			Er steigt vom Fahrrad ab. → Sesedne z kola.
			Du hast mich erschreckt. → Vylekal/Vyděsil jsi mě.
			Er schiebt das Fahrrad neben sich her. → Vede kolo vedle sebe.
			der Sattel \[pl.	-ä\] → sedátko (na kole)
			die Klingel \[pl.	-n\] → zvonek
			die Bremse \[pl.	-n\] → brzda
		}
		13.3.IV {
			der Reifen \[pl.	-\] → pneumatika/guma u kola
			Wir haben uns umarmt. → Objali jsme se.
			Er lehnt sein Fahrrad gegen eine Mauer. → Opře kolo o zeď.
			Was hast du vor? → Co plánuješ?
			die Aufführung \[pl.	-en\] → představení/inscenace
			Sie halten den Atem an. → Zadrží dech.
			Sie gehen Hand in Hand. → Jdou a drží se za ruce.
			der Knotenpunkt \[pl.	-e\] → uzel (dopravní)
			Einsteigen, Türen schließen selbsttätig. → Nastupte, dveře se zavírají automaticky.
			der Informationsschalter \[pl.	-\] → informační přepážka
			die Unterkunft → ubytování
			der Briefumschlag \[pl.	ä-e\] → obálka
			der Hügel \[pl.	-\] → kopec
			Ich bin daheim/(zu Hause). → Jsem doma.
			der Chor \[pl.	ö-e\] → pěvecký sbor
			der Pfad \[pl.	-e\] → stezka
			einpennen/einschlafen → usnout
			das Jurastudium → studium práv
			Viel Erfolg! → Hodně zdaru/úspěchu!
			Du musst dich um alles kümmern. → Musíš se o všechno postaral.
		}
		13.3.V {
			Ich werde meine Eltern nicht belügen. → Nebudu lhát svým rodičům.
			Ich möchte mit den Händen arbeiten. → Chtěl bych manuálně pracovat.
			alles unter einen Hut bringen → dát pod jednu střechu (dát do souladu)
			jemanden über den Tisch ziehen → někoho ošidit, podvést
			Komm doch vorbei. → Stav se.
			Wir treffen uns so gegen Mittag. → Sejdeme se kolem poledne.
			die Leidenschaft → vášeň
			die Körperkraft → tělesná síla
			ein platter Reifen → píchlá pneumatika
			die Staatsangehörigkeit → státní příslušnost
			der Lebenslauf \[pl.	äu-e\] → životopis
			das Studium abschließen → dokončit studium
			die Staatsbürgerschaft → státní občanství
			das Glückskind \[pl.	-er\] → dítě štěstěny
			das Sieb \[pl.	-e\] → síto
			die Teekanne \[pl.	-n\] → čajová konvice
			die Spielkonsole \[pl.	-n\] → hrací konzole
			die Web-Cam \[pl.	-s\] → webová kamera
			die Romanze \[pl.	-n\] → románek/vztah/poměr
			der Blumenstrauß \[pl.	äu-e\] → kytice
		}
	}
	17. 100 §{
		11.9. {
			das Fahrradtour \[pl. -n\] → výlet na kole
			in die Ukraine fahren → jet na Ukrajinu
			Wie viel Kilometer seid ihr täglich gefahren? → Kolik kilometrů jste denně ujeli?
			die Vorbereitung \[pl. -en\] → příprava
			Ich habe weiniger Probleme als befürchtet. → Mám méně problémů, než jsem čekal.
			der Ersatzteil \[pl. -e\] → náhradní díl
			eine durchsichtige Tüte → průhledná taška
			der Fleck \[pl. -en\] → flek
			das Notizbuch \[pl. ü-er\] → poznámkový blok
			Das Messer steckt da griffbereit. → Nůž je tam po ruce.
			die Not → nouze
			der Elefant \[pl. -n\] → slon
			die Unterwäsche → spodní prádlo
			das Höschen \[pl. -\] → kalhotky
			die Unterhose \[pl. -n\] → spodky/trenky
		}
		16.9. {
			der Popo/Po \[pl. -s\] → zadek
			die Stachelbeere \[pl. -n\] → angrešt
			Das schaffen wir schon. → To stíháme.
			Ich muss um Viertel vor eins am Bahnhof sein. → Musím být ve tři čtvrtě na jednu na nádraží.
			Jetzt beruhige dich. → Teď se uklidni.
			Du fährst jetzt los? → Ty teprve teď vyrážíš?
			Wo steckst du denn? → Kde trčíš?
			die Begrüßung \[pl. -en\] → přivítání
			der Gruß \[pl. ü-e\] → pozdrav
			Kommt er rechzeitig zum Bahnhof? - Ja, er ist immer pünktlich. → Přijde včas na nádraží? - Ano, je vždy dochvilný.
			Weihnachten ist vorbei. → Vánoce jsou pryč.
			den Weihnachtsbaum schmücken → ozdobit vánoční stromek
			der Karnevalsumzug \[pl. ü-e\] → masopustní průvod
			(der Karneval/Fasching)/(die Fasnacht/Fastnacht) → masopust
			Ostern ist im Frühling. \[pl. -s\] → Velikonoce jsou na jaře.
			der Karfreitag → Velký pátek
			der Osterhase \[pl. -n\] → velikonoční zajíc
			der Sekt \[pl. -e\] → šampaňské
			die Osterrute \[pl. -n\] → pomlázka
			das Farbband \[pl. ä-er\] → mašle/pentle
		}
		18.9. {
			die Schrift → písmo
			Das Land hat mich fasziniert. → Ta země mě fascinovala.
			sich etwas leihen \[prät.	geliehen\] → něco si půjčit
			die Disziplin → disciplína
			einen Online-Kurs machen → dělat online kurz
			die Band \[pl. -s\] → hudební skupina
			das Band \[pl. ä-er\] → mašle/pentle
			der Band \[pl. ä-e\] → svazek
			verfassen → sepsat/napsat
			Zweimall bin ich hingefallen. → Dvakrát jsem spadl.
		}
		25.9. {
			zu spät anfangen → začít příliš pozdě
			den Zeitplan nicht einhalten → nedodržet časový plán
			etwas anderes machen wollen → chtít dělat něco jiného
			keine klaren Gedanken haben → nemít jasné myšlenky
			Vor dieser Prüfung habe ich Angst. → Před touto zkouškou mám strach.
			Da geht alles durch einander. → To se všechno zamotá.
			der Prüfer → zkoušející
			Mir fällt nichts ein. → Nic mě nenapadá.
			der Lernstoff → látka k učení
			Dar kapier'/check'/blick' ich nicht. → Tomu nerozumím.
			Der versteht nur Bahnhof. → Rozumí tomu jak koza petrželi.
			Die Zeit wird knapp. → Času je málo.
			konsequent → důsledný
			verschieben → přesouvat
		}
		30.9. {
			Ich bin total gestresst. → Jsem naprosto vystresovaný.
			Ich drücke dir die Daumen. → Držím ti palce.
			Das reicht nicht. → To nestačí.
			Ich habe den Eindruck dass alle nicht verstehen. → Mám dojem, že všichni nerozumí.
			Ich habe viele Tests auf einmal. → Mám hodně testů najednou.
			die mündliche Prüfung → ústní zkouška
			Du solltest nicht deine ganze Zeit verplannen. → Neměl bys si rozplánovat všechen svůj čas.
			Atme tief durch. → Zhluboka dýchej.
			gerecht → spravedlivý
			die Erholung → odpočinek
		}
		26.2.2020 - I {
			Welche Berufe haben mit Sprache zu tun? → Která povolání mají co do činění s jazykem?
			zu zweit → po dvou
			zu dritt → po třech
			der Tagesablauf → průběh dne
			Toms Beruf ist Gebärdendolmetscher. → Tomovo povolání je tlumočník znakového jazyka.
			die Gebärdensprache → znakový jazyk
			der Dolmetscher → tlumočník
			dolmetschen → tlumočit
			der Übersetzer → překladatel
			übersetzen → přeložit
			faszinieren → fascinovat
			Jeden Tag mache ich etwas Anderes. → Každý den dělám něco jiného.
			Für j-n, etw. sorgen → starat se o
			begleiten → doprovázet
			gehörlose Menschen → neslyšící lidé
			eine Untersuchung beim Arzt → prohlídka u lékaře
			das Gericht (e) → soud
			das Standesamt → Matrika, matriční úřad
			abwechslungsreich → pestrý (zaměstnání, činnosti, ne barvy)
		}
		26.2.2020 - II {
			die Logopädin → logopedka
			die Praxis (Praxen) → ordinace
			feste Arbeitszeit → pevná pracovní doba
			Das geht noch bis nächsten Sommer so. → Tak to bude (půjde) až do příštího léta.
			das Drehbuch → scénář
			freiberuflich arbeiten → pracovat na volné noze
			Ich bin mein eigener Chef. → Jsem sám svým šéfem.
			bis Mitternacht arbeiten → pracovat do půlnoci
			der Auftrag (ä-e) → zakázka
			einsam → osamělý
			Der Unterricht dauert bis ein Uhr (bis eins). → Vyučování trvá do jedné (hodiny).
			Am Abend lerne ich über eine Stunde. → Večer se učím přes hodinu.
			Ab dem ersten Juni kann ich anfangen. → Od prvního června můžu začít.
			der Alltag → všední den
			die Tänzerin → tanečnice
			An den Arbeitstagen stehe ich um sechs auf. → V pracovní dny vstávám v šest.
			Dänisch → dánština
			Dänemark → Dánsko
			die ganze Welt kennen lernen → poznat celý svět
		}
	}
	18. 100 §{
		26.2.2020 - III {
			der Flugbegleiter  → steward
			Der Beruf ist stressig und anstrengend. → Povolání je stresové a náročné.
			Der Nachteil an diesem Beruf ist die Bezahlung. → Nevýhoda tohoto zaměstnání je plat.
			die Unsicherheit → nejistota
			flexible Arbeitszeiten (Pl.) → flexibilní pracovní doba
			der Laden (ä) = das Geschäft (e) → obchod
			der Hotelfachmann / die Hotelfachfrau → hoteliér/ka
			an der Rezeption arbeiten → pracovat na recepci
			das Fitnessstudio (s) → fitness studio
			die Spätschicht (en) → večerní směna
			vermuten → domnívat se
			begründen → odůvodnit
			der Wert (e) → hodnota
			Marmeladen einkochen = einmachen → zavařovat marmelády
			die Aushilfe (n) → výpomoc
			die Reportage (n) → reportáž
			der Senior (en) → senior
			vorlesen → předčítat
			den Text zusammenfassen → shrnout text
		}
		26.2.2020 - IV {
			eine Frage stellen → položit otázku
			ein Beispiel geben/nennen/anführen → uvést příklad
			den Text gliedern → rozčlenit text
			Was ist deine Meinung? → Jaký je tvůj názor?
			Sie bedanken sich bei den Zuhörern. → Poděkují posluchačům.
			vorbereiten → připravit
			vortragen → přednášet
			j-n ansprechen → oslovit někoho
			der Inhalt (e) → obsah (knihy, přednášky)
			laut genug sprechen → Mluvit dostatečně nahlas
			erwarten → očekávat
			der Manager (-) [ˈmɛnɪdʒɐ] → manažer
			die Kreativität → kreativita
			die Perspektive (n) → perspektiva
			das Seminar (e) → seminář
			herausfinden → zjistit
			die Wirtschaft → hospodářství
			die Fabrik (en) → továrna
			das Gebäude (-) → budova
		}
		26.2.2020 - V {
			motivieren → motivovat
			ein Problem lösen → řešit problém
			anders denken → jinak myslet
			locker → uvolněný, na pohodu
			für ein Produkt werben → propagovat produkt
			ein Seminar fortsetzen → Pokračovat v semináři
			Das hört sich verrückt an, oder? → To zní šíleně, co?
			an der Präsentation teilnehmen → zúčastnit se prezentace
			offene Menschen → otevření lidé
			das Stichwort (ö-er) → heslo (v seznamu, na papíře, nikoliv tajné)
			das Passwort = das Kennwort  → heslo (tajné pro přístup)
			nun = jetzt → nyní
			erstens, zweitens, drittens, viertens → zaprvé, zadruhé, zatřetí, začtvrté
			Sie bewirbt sich um die Arbeitsstelle. → Uchází se o pracovní místo.
			das Mikrofon (e) → mikrofon
			die Mimik → mimika
			die Gestik → gestikulace
			der Moderator (en) → moderátot
			der Sprecher  → mluvčí
		}
		26.2.2020 - VI {
			sportlich → sportovní
			der, das Parkour → parkour
			das Paragliding → paragliding
			reiten → Jezdit na koni
			der Schneeschuh (e) → sněžnice
			tauchen → potápění
			Sport machen/treiben → dělat/provozovat sport
			das Team (s) → tým
			der Sport (Sportarten) → sport (sporty)
			die Vermutung (en) → domněnka
			Ich bin schon mal Fallschirm gesprungen. → Už jsem skákal s padákem.
			der Gegenstand (ä-e) → předmět (věc)
			die Yogamatte (n) → Podložka na jógu
			der Reithelm (e) → jezdecká helma
			die Taucherbrille (n) → potápěčské brýle
			der Gleitschirm (e) → padákový kluzák
			der Sportschuh (e) → sportovní bota
			keine Angst vor Tieren haben → Nemít strach ze zvířat
			die Luft  → vzduch
		}
		26.2.2020 - VII {
			Muskeln anspannen und entspannen → Zatnout a povolit svaly
			das Pferd (e) → kůň
			einen Helm tragen → nosit helmu
			der Schirm (e) → deštník
			Wahnsinn! → To je šílené! (pozitivně)
			der Fan (s) [fɛn] → fanoušek
			Fanartikel kaufen → kupovat fanouškovské zboží
			der, das Poster (-)  → plakát
			Das war großartig! → To bylo velkolepé!
			Sie sind wieder in Topform. → Jsou opět v top formě.
			Das nächste Mal klappt es bestimmt. → Příště to určitě vyjde.
			Das kann doch nicht wahr sein! → To snad nemůže být ani pravda!
			Da kann man wohl nichts machen. → To se asi nedá nic dělat.
			Ich finde es echt schade. → Je to fakt škoda.
			Der FC Bayern München hat verloren. → FC Bayern München prohrál.
			das Spiel (e) → zápas, hra
			das Stadion (Stadien) [ˈʃtaːdi̯ɔn] → stadion
			das Tor (e) → gól
			Du benimmst dich gar nicht wie ein Star. → Vůbec se nechováš jako hvězda.
		}
	}
	19. 100 §{
		26.2.2020 - VIII {
			treu → věrný
			die Mannschaft (en) → mužstvo, tým
			berühmt → slavný
			bekannt → známý
			Er hat ein Tor geschossen. → Vstřelil branku.
			die Folge (n) → následek
			Es regnet stark. → Silně prší.
			Ein wunderbarer Sieg! → Úžasné vítězství!
			So viel Pech! → Tolik smůly! (Taková smůla!)
			Wir sind die Besten! → Jsme ti nejlepší!
			Die Niederlage tut weh. → Prohra bolí.
			enttäuscht → zklamaný
			der Kommentar (e) → komentář
			das Spiel gegen Frankreich → zápas proti Francii
			der Tormann → brankař
			die Riesenchance (n) → obrovská šance
			die Halbzeit  → poločas
			Das war heute nicht mein Tag. → Dnes to nebyl můj den.
			Es ist vorbei. → Je to pryč.
		}
		26.2.2020 - IX {
			gerecht → spravedli
			fair → fairový
			Sie haben den Sieg verdient. → Nezasloužili si vítězství.
			der Eintritt → vstup
			unterstützen → podporovat
			die Stimmung → nálada
			Ich bin stolz auf dich. → Jsem na tebe pyšná.
			Sie ist schon einmal vom Pferd gefallen. → Jednou spadla z koně.
			die Medaille (n) [meˈdaljə] → medaile
			die Goldmedaille → zlatá medaile
			die olympischen Spiele → olympijské hry
			der Ausdruck (ü-e) → výraz
			der Hit (s) → hit
			brennen → hořet
			die Hymne (n) → hymna
			der Skifahrer (-) → lyžař
			die Saison (s) [zɛˈzɔ̃ː] → sezona
			die Konkurrenz → konkurence
			international → mezinárodní
		}
		26.2.2020 - X {
			der Lieblingssong (s) → oblíbená píseň
			ein tolles Lied → skvělá píseň
			Mir ist nicht nach Lachen zumute. → Není mi do smíchu.
			die Kondition → kondice
			Was schlägt sie vor? → Co navrhuje?
			Wofür haben sie sich entschieden? → Pro co se rozhodli?
			Darf ich etwas vorschlagen? → Smím (Můžu) něco navrhnout?
			der Vorschlag (ä-e) → návrh
			Was hältst du von dieser Idee? → Co si myslíš o tomato nápadu?
			Einverstanden. → Domluveno.
			Wollen wir lieber ins Restaurant gehen? → Nepůjdeme raději do restaurace?
			Das passt mir gut. → To se mi hodí.
			keine Lust auf Sport haben → nemít chuť na sport
			sich bewegen → hýbat se
			eine Fahrradtour machen → udělat si projížďku na kole
			das Seil → lano
			die Pinnwand (ä-e) → nástěnka (korková)
			sich etwas ausleihen → něco si vypůjčit
			der Profi (s) → profík
		}
		26.2.2020 - XI {
			der Stapel (-) → štos, hromada
			Was hältst du davon? → Co si o tom myslíš?
			Leider geht das nicht. → Bohužel to nejde.
			schenken → darovat
			zurückgeben → vrátit
			der Schatz → poklad
			der Absatz (ä-e) = der Abschnitt (e) → odstavec
			Sie sind auf der Suche nach dem Schatz. → Hledají poklad.
			die Art (en) → způsob
			verstecken → schovat
			sogenannt → tzv.
			das Versteck → úkryt
			der Behälter (-) → nádoba
			wasserdicht → voděodolný
			der Tresor → trezor
			die Dose (n) → plechovka
			schützen → chránit
			kaputtgehen → rozbít se
			tauschen → vyměňovat
		}
		26.2.2020 - XII {
			hineinlegen → vložit (dovnitř něčeho)
			die Internetadresse (n) → internetová adresa
			ein Spaß für Jung und Alt → Zábava pro mladé i starší
			graben → kopat, rýt, hloubit
			die Erde  → Země, země
			das Loch (ö-er) → díra
			die Pflanze (n) → rostlina
			die Höhle (n) → jeskyně
			die Hölle → peklo
			das Gelände (-) → oblast, krajina, terén
			gleichzeitig → současně
			die Stadtbesichtigung → prohlídka města
			die Koordinate (n) → souřadnice
			die Besonderheit (en) → zvláštnost
			die Freizeitbeschäftigung (en) → volnočasová činnost
			der Trend (s) → trend
			Das hört sich spannend an. → To zní napínavě.
			unbedingt → bezpodmínečně
			der Anfänger  → začátečník
		}
	}
	20. 100 §{
		26.2.2020 - XIII {
			Welche Kleidung trägt sie? → Jaké oblečení nosí?
			Was ist passiert? → Co se stalo?
			begeistert → nadšený
			gut/schlecht gelaunt → dobře/špatně naladěný
			das Abseits (-) → ofsajd
			blind → slepý
			der Elfmeter (-) → pokutový kop, penalta
			der Schiri (s) → rozhodčí (hovorově)
			der Schiedsrichter (-) → rozhodčí
			pfeifen (gepfiffen) → pískat
			das Hausboot (s) → hausbót
			schaukeln → houpat se, kolébat se
			die Jahreszeit (en) → roční období
			frisch → čerstvý
			das Ufer (-) → břeh, náplavka
			genial → geniální
			die Wolke (n) → mrak
			spiegeln → zrcadlit se
			überlegen → přemýšlet, rozmýšlet
		}
		26.2.2020 - XIV {
			der Keller  → sklep
			der Kellner (-) → číšník
			die Terrasse (n) → terasa
			Was gefällt dir am besten? → Co se ti líbí nejvíc?
			verschieden → různý
			der Bauernhof (ö-e) → statek
			bewohnt → obydlený
			entfernt → vzdálený
			mitten in der Natur → uprostřed přírody
			renovieren → renovovat
			die Ferienwohnung → prázdninový byt
			die Insel (n) → ostrov
			speziell → speciální, zvláštní
			auf dem Land(e) → na venkově
			die Treppe (n) → schodiště
			die Stufe (n) → schod
			das Dach (ä-er) → střecha
			der Flur (e) → chodba
			das Bad (ä-er) = das Badezimmer (-) → koupelna
		}
		26.2.2020 - XV {
			das Stadtleben → městský život
			zufrieden → spokojený
			am Stadtrand → na okraji města, na předměstí
			grillen (CH: grillieren) → grilovat
			anonym → anonymně
			mitten in der Stadt → uprostřed města
			eine halbe Stunde mit dem Auto fahren → jet autem půl hodiny
			merken → všimnout si
			sich beschweren → stěžovat si
			die Nachbarn zum Kaffee einladen → pozvat sousedy na kafe
			bellen → štěkat
			das Rad abstellen → odstavit kolo
			verboten → zakázaný
			der Rauch → kouř
			stinken → smrdět
			der Eingang → vchod
			Es stört mich, wenn ... → Vadí mi, když ...
			Das habe ich nicht gewusst. → To jsem nevěděl.
			Das kommt nicht mehr vor. → To se už nestane.
		}
		26.2.2020 - XVI {
			Ist ja schon gut. → To je dobrý.
			Na gut, ist nicht so schlimm. → No, dobře, to není tak hrozné.
			Vergessen wir das.  → Zapomeňme na to.
			Das ist schon in Ordnung. → To je v pořádku.
			der Konflikt (e) → konflikt
			Ich möchte mich entschuldigen. → Chtěl bych se omluvit.
			abschließen → zamknout
			sich fühlen → cítit se
			der Kinderwagen (ä) → kočárek
			das Treppenhaus (äu-er) → schodiště (samostatná místnost)
			die Mülltonne (n) → poplenice
			die Tür aufmachen/öffnen → otevřít dveře
			das Fenster zumachen/schließen → zavřít okno
			Ich erwarte ein Paket. → Očekávám balíček.
			Können Sie das Paket für mich annehmen? → Můžete za mě ten balíček převzít?
			die Spülmaschine ausräumen → vyskládat myčku
			die Kinder abholen → vyzvednout děti
			den Briefkasten leeren → vybrat poštovní schránku
			die Katze füttern → krmit kočku
		}
		26.2.2020 - XVII {
			der Bleistift (e) → tužka
			Könnten Sie bitte Seite 22 aufschlagen? → Mohli byste si prosím otevřít stranu 22?
			einziehen (bin eingezogen) → nastěhovat se
			umziehen (bin umgezogen) → přestěhovat se
			ausziehen (bin ausgezogen) → odstěhovat se
			sich anziehen (habe mich angezogen) → obléknout se
			sich umziehen (habe mich umgezogen) → převléknout se
			sich ausziehen (habe mich ausgezogen) → svléci se
			sich verabschieden → rozloučit se
			den Umzugswagen bestellen → objednat stěhovací vůz
			Sachen packen → balit věci
			sich anmelden → přihlásit se
			sich abmelden → odhlásit se
			das Semester (-) → semestr
			versprechen → slíbit
			auf das Kind aufpassen → dávat pozor na dítě
			den Umzug vorbereiten → připravit stěhování
			den Job kündigen → dát v práci výpověď
			das Zeugnis (se) → vysvědčení, osvědčení
		}
	}
	21. 100 §{
		26.2.2020 - XVIII {
			Wir haben uns lange unterhalten. → Dlouho jsme se bavili.
			Wie läuft es denn bei dir? → Jak to běží u tebe?
			sich verirren → zabloudit
			Ich kenne mich hier gut aus. → Vyznám se tady dobře.
			der Mitstudent (en) → Spolužák (na VŠ)
			nach dem Weg fragen → ptát se na cestu
			ein elektrisches Gerät → elektrický přístroj
			die Wand (ä-e) → stěna
			die Reparatur (en) → oprava
			erlauben → dovolit
			mieten → (pro)najmout si
			vermieten → pronajmout (někomu)
			der Strom → elektřina
			der Aufzug (ü-e) = der Fahrstuhl (ü-e) = der Lift (s,e) → výtah
			das Apartment (s) [aˈpartmənt] = das Appartement (s) [apart(ə)ˈmɑ̃ː] → garsonka
			die Unterkunft → ubytování
			die Gebühr (en) → poplatek
			ordentlich → uspořádaný
			putzen → uklízet, čistit
		}
		26.2.2020 - XIX {
			auspacken → vybalit
			erholsam → odpočinkový
			sich um etwas kümmern → starat se o něco
			das Camping → kempování
			jeden Morgen zum Bäcker gehen → chodit každé ráno k pekaři
			die Laune (n) → nálada
			in Urlaub fahren → jet na dovolenou
			krank werden → onemocnět
			den Schlüssel verlieren → ztratit klíč
			der Tourismus → turismus
			bauen → stavět
			der Architekt (en) → architekt
			die Synagoge (n) → synagoga
			der Bau (Bauten) → stavba
			die Bühne (n) → jeviště
			der Zweite Weltkrieg → druhá světová válka
			der Gottesdient (e) → bohoslužba
			der Hof (ö-e) → dvůr
			die Galerie (n) → galerie
		}
		26.2.2020 - XX {
			im Norden von Deutschland liegen → ležet na severu Německa
			südlich vom Stadtzentrum → jižně od centra města
			das Kätzchen (-) → kočička
			das Haustier (e) → domácí mazlíček
			die Milliarde (n) (Mrd.) → miliarda
			die Million (n) (Mio.) → milion
			die Ratte (n) → krysa
			der Haushalt (e) → domácnost
			modisch → módní
			der Tierarzt (ä-e) → zvěrolékař
			das Futter → krmení
			Das ist bei uns ganz anders. → To je u nás úplně jiné.
			das Tierheim (e) → útulek
			die Schildkröte (n) → želva
			das Meerschweinchen (-) → morče
			das Junge (n) → mláďata
			der Junge (n) → kluk
			der Nymphensittich (e) → korela chocholatá (papoušek)
			eine Allergie auf Tierhaare → alergie na zvířecí chlupy
		}
		26.2.2020 - XXI {
			das Huhn (ü-er) → kur, slepice
			der Zoo (s) → zoo
			der Elefant (en) → slon
			die Fotomontage (n) → fotomontáž
			zufällig → náhodou
			Der Mann drückt den Selbstauslöser. → Muž stiskne samospoušť. (při fotografování)
			neugierig → zvědavý
			Ich freue mich auf die Sommerferien. → Těším se na letní prázdniny.
			Ich freue mich über die Nachricht. → Těším se ze zprávy. (Mám radost ze zrpávy.)
			die Ente (n) → kachna
			die Gans (ä-e) → husa
			das Küken (-) → kuřátko
			die Straße überqueren → přejít ulici
			munter → veselý, radostný, svěží (člověk)
			die Kuh (ü-e) → kráva
			der Zaun (äu-e) → plot
			das Spiegelbild (er) → zrcadlový obraz
			idyllisch → idylický
			der eigene Garten → vlastní zahrada
		}
		26.2.2020 - XXII {
			der Mitbewohner (-) → spolubydlící
			Mach die Musik leiser! → Ztiš tu hudbu!
			Wir verstehen ja unser eigenes Wort nicht. → Nerozumíme vlastnímu slovu.
			Rücksicht nehmen → brát ohled
			die Bohrmaschine (n) → vrtačka
			im zehnten Stock → v desátém podlaží
			am Wüstenrand → na okraji pouště
			die Abfallhalde (n) → hromada odpadků
			die Bergeswand (ä-e) → horská stěna
			die Kammer (n) → komora
			die Not → nouze
			der Jammer → nářek, žel
			sorgenlos → bezstarostný
			der Mond → měsíc (na obloze)
			ärmlich → bídný
			das Rind (er) → skot
			brüllen → bučet
			grunzen → chrochtat
			miauen → mňoukat
		}
	}
	22. 100 §{
		26.2.2020 - XXIII {
			Gänse schnattern → husy kejhají
			Ziegen meckern → kozy mečí
			Bienen summen → Včely bzučí
			Grillen zirpen → cvrčci cvrkají
			Frösche quaken → žáby kvákají
			Hummeln brummen → včeláci bzučí
			Vögel zwitschern → ptáci cvrlikají
			das meistverkaufte Buch → nejprodávanější kniha
			das Parfüm (e → s) = das Parfum (s) [parˈfŒ̃ː]
			Das Buch ist 1958 erschienen. → Kniha vyšla v roce 1958.
			der Bestseller (-) → bestseller
			die Verfilmung (en) → filmové zpracování
			der Ring (e) → prsten
			das Hauptwerk (e) → hlavní dílo
			Er arbeitet an einem neuen Projekt. → Pracuje na novém projektu.
			das Orchester (-) [ɔrˈkɛstɐ] → orchestr
			der Solist (en) → sólista
			der Chor (Chöre) [koːɐ̯] → sbor (hudební)
			das Budget (s) [byˈdʒeː] → rozpočet
		}
		26.2.2020 - XXIV {
			die Schlossführung  → prohlídka zámku
			der Autor (en) → autor
			ein spannender Film → napínavý film
			das Album (Alben) → album
			weinen → brečet, plakat
			das Amphitheater (-) → amfiteátr
			die Arena (Arenen) → aréna
			der Römer (-) → Říman
			der Fernsehturm (ü-e) → televizní věž
			die Philharmonie → filharmonie
			die Elbe → Labe
			der Kakao [kaˈkaʊ̯], auch: [kaˈkaːo] → kakao
			Lateinamerika → Latinská Amerika
			der Umbau → přestavba
			entstehen → vzniknout
			das Lagerhaus → sklad
			die Show (s) → show
			sich orientieren → orientovat se
			ein Konzert geben → uspořádat koncert
		}
		26.2.2020 - XXV {
			der Jazz → jazz
			der Rock = die Rockmusik → rock
			die Klassik = die klassische Musik → vážná hudba
			der Hip-Hop → hip-hop
			Was für ein Auto möchtest du haben? - Ich möchte ein schnelles Auto haben. → Jaké auto bys chtěl mít? - Chtěl bych mít rychlé auto.
			Welches Auto möchtest du haben? - Ich möchte einen Mercedes haben. → Které auto bys chtěl mít? - Chtěl bych mít Mercedes.
			ins Konzert gehen → jít na koncert
			der Sitzplatz → místo k sezení
			der Stehplatz  → místo k stání
			bar zahlen → platit hotově
			die Überweisung → bankovní převod
			die Kreditkarte  → kreditní karta
			der Käufer → nákupčí
			der Ausschnitt (e) → úryvek, výstřižek
			Wieso? → Jak to?
			Jazz ist nicht so mein Ding. → Jazz není můj šálek kávy.
			das Programm (e) → program
			Kann ich Musik anmachen? → Můžu pustit hudbu?
			der Rabatt (e) → sleva
		}
		26.2.2020 - XXVI {
			die Mehrwertsteuer (MwSt) → daň z přidané hodnoty
			netto → čistý (plat)
			brutto  → hrubý (plat)
			die Quittung  → účtenka
			das Konto (Konten, Kontos, Konti) → konto
			die Rechnung → faktura
			der Artikel (-) → zboží
			der Einzelpreis (e) → jednotková cena
			der Gesamtpreis → celková cena
			der Gesamtbetrag (ä-e) → celková částka
			die Bankleitzahl (en) → kód banky
			die Summe (n) = der Betrag (ä-e) → částka
			enthalten (es enthält) → obsahovat
			bedienen → obsloužit
			das Geld auf ein Konto überweisen → převést peníze na účet
			die Kontonummer (n) → číslo účtu
			alles am Eingang abgeben → vše odevzdat u vchodu
			der Kontrolleur (e) → kontrolor
			Hast du was? → Je ti něco?
		}
		26.2.2020 - XXVII {
			Ich muss dir mal was sagen. → Musím ti něco povědět.
			Ich bin schon unterwegs zum Konzert. → Jsem už na cestě na koncert.
			verschlafen = verpennen  → zaspat
			seine zweijährige Tochter → jeho dvouletá dcera
			müde → unavený
			der Einsatz → nasazení
			die Ansage (n) → ohlášení, oznámení
			die Stille → ticho, klid
			die Panne (n) → porucha
			Alles geht nicht immer glatt. → Všechno nejde vždy hladce.
			der Komiker  → komik
			feststellen → zjistit
			der Witz (e) → vtip
			der/die Prominente (n) → slavný člověk (muž/žena)
			einen Film drehen → natáčet film
			das Stück (e) → kus (též divadelní)
			das Finale → finále
			die Hauptrolle (n) → hlavní role
			Wer ist da drüben? → Kdo je tam naproti?
		}
	}
	23. 100 §{
		26.2.2020 - XXIX {
			die Malerei → malířství
			die Ausstellung → výstava
			das Jahrhundert (e) → století
			der Maler (-) → malíř
			Interesse an Tieren haben → mít zájem o zvířata
			aus Erinnerung malen → malovat z paměti (ze vzpomínek)
			der Hase (n) → zajíc
			exakt → přesný, exaktní
			oben rechts → nahoře vpravo
			unten links → dole vlevo
			im Hintergrund → v pozadí
			im Vordergrund → v popředí
			hinten → vzadu
			vorne → vepředu
			in der Ecke → v rohu
			die Kulisse (n) → kulisa
			sich verkleiden (als) → převléci se (za něco)
			die Maske (n) → maska
			der Drehtag → den natáčení
		}
		26.2.2020 - XXX {
			der Drehort (e) → natáčecí místo
			die Requisiten (Pl.) → rekvizity
			der Einkaufswagen (ä) → nákupní košík
			die Skulptur (en) → plastika, socha
			der Blumenstrauß (äu-e) → kytice
			Die Zeit vergeht schnell. → Čas rychle plyne.
			zur Arbeit gehen → jít do práce
			sich beruflich engagieren → pracovně se angažovat
			das Leben genießen → užívat si života
			eine Familie gründen → založit rodinu
			die Welt kennen lernen → poznat svět
			der Enkel (-) = der Enkelsohn (ö-e) → vnuk
			die Enkelin (nen) = die Enkeltochter (ö) → vnučka
			Mit sechs Jahren habe ich meistens gespielt. → V šesti letech jsem si většinou (především) hrál.
			der Rentner  → důchodce
			betrunken → opilý
			bluten → krvácet
			verletzt → zraněný
			gegen einen Baum fahren → vjet do stromu
		}
		26.2.2020 - XXXI {
			lügen → lhát
			schwanger → těhotná
			die Untersuchung  → Vyšetření (lékařské)
			Blut abnehmen → vzít krev
			versprechen → slíbit
			Warte nicht auf mich. → Nečekej na mě.
			der Kiosk → kiosk
			das Heimweh → stesk po domově
			pensioniert sein → být v důchodu
			die Fete (n) → oslava
			mehr mit Freunden unternehmen → podnikat toho více s přáteli
			erledigen → vyřídit (úkol, záležitost, ne zprávu)
			Das Telefon klingelt. → Telefon zvoní.
			sich ausruhen = sich entspannen = sich erholen → odpočinout si
			die Mittagspause → obědová přestávka
			An deiner Stelle würde ich mehr lernen. → Být na tvém místě, tak se víc učím.
			der/das Kajak → kajak
			einen Kuchen backen → péct koláč
			sich an etw./j-n erinnern → vzpomínat si na, pamatovat si na
		}
		26.2.2020 - XXXII {
			Von mir aus gern. → Za mě rád.
			Das wäre super. → To by bylo super.
			Da hast du recht. → To máš pravdu.
			Alles klar auf der Kajaktour? → Všechno v pohodě na kajakové projížďce?
			sich über etw./j-n ärgern → zlobit se na
			die Prüfung verschieben → posunout zkoušku
			der Tagesplan (ä-e) → denní plán
			das Handtuch (ü-er) → ručník
			denken an etw./j-n → myslet na
			Was hast du morgen vor? → Co plánuješ na zítřek?
			Wann möchtest du losfahren? → Kdy bys chtěla vyjet?
			Ich ruf dich vorher einfach an. → Předtím ti prostě zavolám.
			Ich kann um sieben am Schwimmbad sein. → V sedm můžu být u bazénu.
			Sie sind jetzt im Schwimmbad. → Jsou teď v bazénu.
			sich für etw./j-n interessieren → zajímat se o
			sich über etw./j-n unterhalten → bavit se o
			über etw./j-n diskutieren → diskutovat o
			der Vorschlag (ä-e) → návrh
			Das schaffe ich nicht. → To nezvládnu/nestihnu.
		}
		26.2.2020 - XXVIII {
			Wasser ist mein Element. → Voda je můj živel.
			selbstkritisch → sebekritický
			Woran liegt es? → Na čem to záleží?
			das Privatleben (-) → soukromý život
			der Trainer (-) → trenér
			der Psychologe (n) → psycholog
			Ich kann besser mit meinen Gefühlen umgehen. → Umím lépe zacházet se svými pocity.
			die Karriere beenden → ukončit kariéru
			das Hotel leiten → vést hotel
			der Punkt (e) → tečka
			das Komma (s) → čárka
			das Fragezeichen (-) → otazník
			das Ausrufezeichen → vykřičník
			der Doppelpunkt → dvojtečka
			der Gedankenstrich (e) → pomlčka
			die Anführungszeichen (Pl.) (unten, oben) → uvozovky (dole, nahoře)
			erwachsen  → dospělý
			die Sprachenschule → jazyková škola
			Argentinien → Argentina
		}
	}
	24. 100 §{
		15.6. - I {
			Was hast du damit zu tun? → Co s tím máš společného?
			der Tagesablauf \[pl. äu-e\] → průběh dne \ denní režim
			faszinieren → fascinovat
			Sie haben Sprachen zu ihrem Beruf gemacht. → Z jazyků udělali svou práci.
			die Gebärdensprache → znaková řeč
			Ich sorge für gute Kommunikation zwischen den Menschen → Starám se o doubrou komunikaci mezi lidmi.
			begleiten → doprovázet
			gehörlos → hluchý
			eine Untersuchung beim Arzt → prohlídka u lékaře
			dolmetschen → překládat
			das Standesamt → matrika
			abwechslungsreich → činnostně pestrý/rozmanitý
			der Auftrag \[pl. ä-e\] → zakázka
			An anderen Tagen habe ich komplett frei. → V jiné dny mám úplně volno.
			der Logopäde \[pl. -n\] → logoped
			die Praxis \[pl. Praxen\] → ordinace
			über eine Stunde → přes hodinu
			der Übersetzer → překladatel
			das Drehbuch → scénář
			freiberuflich arbeiten → pracovat na volné noze
		}
		15.6. - II {
			einsam → osamocený
			Der Unterricht dauert bis (ein Uhr)/eins. → Vyučování trvá do jedné hodiny.
			ab dem ersten Juni → od prvního června
			an den Arbeitstagen → v pracovní dny
			im Wert von 5 000 Euro → v hodnotě 5 000 euro
			einkochen/einmachen → zavařovat
			die Frucht \[pl. ü-e\] → plod
			fruchtbar → plodný
			furchtbar → otřesný
			die Reportage \[pl. -n\] → reportáž
			der Treffpunkt \[pl. -e\] → místo setkání
			der Senior \[pl. -en\] → senior
			erwarten → očekávat
			die Erwartung → očekávání
			das Stichwort \[pl. ö-er\] → poznámkové heslo
			vorlesen → předčítat
			die Vorlesung → přednáška
			Ich habe das Thema gewählt, weil ... → Vzbral jsem si téma, protože ...
			kurz zusammenfassen → krátce shrnout
			Mir gefällt besonders, dass ... → Obzvlášť se mi líbí, že ...
		}
		15.6. - III {
			ein Beispiel geben → dát příklad
			erstens, zweitens, drittens, viertens ... → zaprvé, zadruhé, zatřetí, začtvrté ...
			die Gliederung → rozčlenění
			Bedanken Sie sich bei Ihren Zuhörern. → Poděkujte svým posluchačům.
			Danken Sie Ihren Zuhörern. → Poděkujte svým posluchačům.
			Gibt es noch Fragen? → Jsou ještě nějaké otázky?
			die Zuhörer direkt ansprechen → oslovit posluchače přímo
			ein Interessanter Inhalt → zajímavý obsah
			laut genug sprechen → mluvit dost nahlas
			etwas auswendig lernen → naučit se něco nazpaměť
			Worüber sprechen sie? → O čem mluví?
			ein Konzert besuchen → jít na koncert
			ins Konzert gehen → jít na koncert
			sich um eine Stelle bewerben → ucházet se o místo
			die Mimik → mimika
			die Gestik → gestikulace
			das Paragliding → paragliding
			der/das Yoga → jóga
			reiten → jezdit na koni
			Schneeschuhwandern → turistika ve sněžnicích
			tauchen → potápět se
			das Team \[pl. -s\] → tým
		}
		15.6. - IV {
			Fallschirm springen → seskok padákem
			zeichen → kreslit
			der Gegenstand \[pl. ä-e\] → předmět
			die Vergangenheit → minulost
			der Fernsehsender → televizní stanice
			der Strom → elektřina
			das Kerzenlicht → světlo svíček
			Wäsche waschen → prát prádlo
			warme Kleidung anziehen → obléknout si teplé prádlo
			die Pflanze → rostlina
			die Lücke → mezera (v textu)
			Morgenstunde hat Gold im Munde. → Ranní ptáče dál doskáče.
			Zeit ist Geld. → Čas jsou peníze.
			Die Zeit heilt alle Wunden. → Čas hojí všechny rány.
			Geduld haben → mít trpělivost
			die Enttäuschung → zklamání
			enttäuscht → zklamaný
			enttäuschen → zklamat
			Im Moment bin ich dauernd unterwegs. → Momentálně jsem neustálě na cestách.
			der perfekte Start ins Berufsleben → perfektní start do pracovního života
		}
		15.6. - V {
			Ich will mehr Zeit für mich. → Chci více času pro sebe.
			Martin unterstützt mich voll. → Martin mě plně podporuje.
			die Vermutung → doměnka/tušení
			Äthiopien → Ethiopie
			Das hat mich beeindruckt. → To na mě udělalo dojem.
			die Gastfreundschaft → pohostinnost
			die Zeremonie → obřad
			zum Kaffee einladen → pozvat na kávu
			der Gastgeber → hostitel
			die Kaffeebohnen → kávové boby
			rösten → opékat
			die Wanderschaft → vandr
			der Tischler → stolař
			der Junggeselle \[pl. -n\] → starý mládenec
			der Heimatort → rodiště
			bei jedem Wetter → při každém počasí
			das Erntedankfest → díkuvzdání
			der Maibaum → májka (strom)
			der Abschnitt \[pl. -e\] → odstavec
			der Absatz \[pl. ä-e\] → odstavec
			die Diplomarbeit → diplomová práce
		}
	}
	25. 100 §{
		15.6. - VI {
			Er hat mich immer so komisch angesehen. → Vždycky si mě tak divně prohlížel.
			die Schuhe ausziehen → vyzout si boty
			einzig → jediný
			einzeln → jednotlivý
			einzigartig → jedinečný
			über die Straße gehen → jít přes ulici
			die Straße überqueren → jít přes ulici
			Es ist rot (an der Ampel). → Je červená (na semaforu).
			die Hausschuhe → papuče
			bei Rot über die Straße gehen → jít přes přechod na červenou
			an der Ampel warten → čekat na semaforu
			der Rat/Ratschläge → rada
			der Kulturknigge → pravidla slušného chování
			der Beitrag \[pl. ä-e\] → příspěvek
			Ich muss mir die Nase putzen. → Musím se vysmrkat.
			auf keinen Fall → v žádném případě
			die Nase hochziehen → popotahovat nosem
			vorsichtig → opatrně
			schlürfen → srkat
			schmatzen → mlaskat
			ganz einfach → úplně jednoduše
		}
		15.6. - VII {
			ein Geschenk mitbringen → vzít s sebou dárek
			Freude machen → dělat radost
			Das wirkt unhöflich. → To püsobí nezdvořile.
			die anderen stören → rušit ostatní
			die anderen nicht warten lassen → nenechat ostatní čekat
			Ich duze ihn. \[akkusativ\] → Tykám mu.
			Ich sieze sie. → Vykám jim.
			die Anrede → oslovení
			Können wir per du sein? → Můžeme si tykat?
			der Tipp \[pl. -s\] → tip
			die Distanz → vzdálenost
			Ich will mit ihm nicht so befreundet sein. → Nechci se s ním tak přátelit.
			das Schulalter → školní věk
			sich näher kennen → znát se blíže
			Leute im gleichen Alter → lidé ve stejném věku
			Generell gilt, dass ... → Všeobecně platí, že ...
			der Beamte → úředník
			Geben Sie Acht! → Dávejte si pozor!
			die Bergtour \[pl. -en\] → horská túra
			das Klischee \[pl. -s\] → klišé
		}
		15.6. - VIII {
			Es ist mir aufgefallen, dass ... → Bylo mi nápadné, že ...
			Ski fahren → lyžovat
			die Ausnahme → výjimka
			die Kaiserzeit → doba císařská
			der Opernball → operní ples
			altmodisch → staromódní
			beleidigt → urazit
			beleidigend → urážlivý
			Zum Schluss möchte ich sagen, dass ... → Nazávěr/Nakonec bych chtěl říct, že ...
			der Pfannkuchen → kobliha \ palačinka
			spießig → úzkoprsý
			der Eindruck \[pl. ü-e\] → dojem
			die Fernsehshow \[pl. -s\] → televizní show
			das Symbol \[pl. -e\] → symbol
			spannend → napínavý
			das Privatleben → soukromý život
			eine große Rolle spielen → hrát důležitou/velkou roli
			ausverkauft → vyprodaný
			Worauf musst du dich vorbereiten? → Na co se musíš připravit?
		}
		15.6. - IX {
			selbst gekochtes Essen → domácky uvařené jídlo
			Das ist eine lange Strecke. → To je dlouhá cesta.
			Das ist mir sehr wichtig. → To je pro mě velmi důležité.
			den Blickkontakt aufnehmen → navázat oční kontakt
			das Geheimnis \[pl. -se\] → tajemství
			die Nordsee → Severní moře
			ähnlich → podobný
			wahnsinnig kalt → šíleně studený
			der Wind → vítr
			erholsam → odpočinkový
			das Boot \[pl. -e\] → člun
			frustriert → frustrovaný
			übernachten → přespat
			das Urlaubszeite → destinace
			Sie fahren immer an den gleichen Ort. → Pořád jezdí na stejné místo.
			zu stressig → příliš stresující
			Hast du vor, nach Italien zu fahren? → Plánuješ jet do Itálie?
			die Kreuzfahrt → okružní plavba
			Wofür entscheidest du dich? → Pro co se rozhodneš?
			eine Reisen buchen → zarezervovat si cestu
		}
		15.6. - X {
			Was ist im Preis inbegriffen? → Co je zahrnuto v ceně?
			Das muss ich mir noch mal überlegen. → To si musím ještě rozmyslet.
			Der Preis ist inklusive Halbpension. → Cena je včetně polopenze.
			der Service → služba
			sich verwöhnen lassen → nechat se rozmazlovat
			Lassen Sie sich von uns beraten. → Nechte si od nás poradit.
			bügeln → žehlit
			reinigen → čistit
			Kinder betreuen → starat se o děti
			Sie wussten keinen Bescheid. → Nic nevěděli.
			wenigstens/mindestens → alespoň
			 Du hast Schwein gehabt! → Měl jsi štěstí!
			Ich bin schon erleichtert. → Už se mi ulevilo.
			So ein Dusel! → Takové štěstí!
			erschrecken → vystrašit
			die Flugbegleiterin → letuška
			der Gang → chodba/ulička
			das Gepäckfach \[pl. ä-er\] → schránka na zavazadla
			verlegen sein → být v rozpacích
			verzweifelt → zoufalý
		}
	}
	26. 100 §{
		15.6. - XI {
			die Sitzreihe → řada sedadel
			verhaften → vzít do vazby
			Ohren auf! → Nastražte uši!
			An welchem Gepäckband finden wir unsere Koffer? → Na kterém páse pro zavazadla najdeme naše kufry?
			an der Bushaltestelle → na autobusové zastávce
			an die Bushaltestelle → na autobusovou zastávku
			Du kannst dir das Essen bringen lassen. → Můžeš si nechat přinést jídlo.
			Ich kann es kaum fassen. → Sotva to můžu pochopit.
			der Rückblick → ohlédnutí se zpět
			die Alm \[pl. -en\] → horská pastvina
			die Käserei → sýrárna
			die Höhe → výška
			ansonsten → jinak
			Mein Handy hat meistens keinen Empfang. → Můj mobil nemá většinou žádný signál.
			die Einsamkeit → osamělost
			Kühe melken → dojit krávy
			der Sonnenaufgang → východ slunce
			der Sonnenuntergang → západ slunce
			im Gegensatz zu meinem normalen Leben → oproti mému normálnímu životu
			die Weide \[pl. -n\] → pastvina
		}
		15.6. - XII {
			Ich habe mich erkältet. → Nachladil jsem se.
			der Kräutertee → bylinný čaj
			der Kran \[pl. ä-e\] → jeřáb
			bewohnbar → obyvatelný
			das Kunstwerk \[pl. -e\] → umělecké dílo
			der Sarg \[pl. ä-e\] → rakev
			der Leuchtturm \[pl. ü-e\] → maják
			der Holzhaufen → kopa dříví
			die Vorliebe \[pl. -n\] → záliba
			die Abneigung → odpor/averze
			die Zeitschaltuhr → přepínací hodiny (minutka)
			die Einparkhilfe → parkovací asistent
			der Türöffner mit Zahlencode → zařízení na otevírání dveří s kódovačem
			ein irres Ding → skvělá/úžasná věc
			Es war einfach ein Muss! → Každý to prostě musel mít! \ Byla to prostě nezbytnost!
			Der Ball war nicht im Aus. → Míč nebyl v autu.
			der Gegner → protivník
			Der Akku ist schnell leer. → Baterka se rychle vybíjí.
			die Produktbeschreibung → popis zboží
			die Bewertung → recenze
		}
		15.6. - XIII {
			der Werbeprospekt \[pl. -e\] → leták
			die Fachzeitschrift \[pl. -en\] → odborný časopis
			die Preise vergleichen → srovnávat ceny
			das Sonderangebot → slevová nabídka
			Kann ich das Gerät bitte umtauschen? → Můžu ten přístroj prosím vyměnit?
			Das finde ich wirklich ärgerlich. → To mi přijde opravdu nemilé/mrzuté.
			Was schlägt sie vor? → Co navrhuje?
			Ich kann verstehen, dass Sie verärgert sind. → Chápu, že jste naštvaná.
			der Kassenzettel → účtenka
			der Farbdrucker \[pl. -\] → barevná tiskárna
			die Farbpatrone → náplň do tiskárny
			das Elektrogeschäft → obchod s elektrospotřebiči \ elektro
			die Tintenpatronen einsetzen → vsadit inkoustové náplně
			den Drucker an Computer anschließen → připojit tiskárnu k počítači
			in der Zukunft → v budoucnosti
			Welche Möglichkeit gefällt dir am besten? → Jaká možnost se Ti líbí nejvíc?
			Wir haben uns umgesehen. → Porozhlédli jsme se.
			der Neubau \[pl. -ten\] → novostavba
			die Bewohner des Hauses → obyvatelé domu
			hereinkommen → vstoupit
		}
		15.6. - XIV {
			den Bildschirm berühren → dotknout se obrazovky
			apropos → co se týče
			der Inhalt des Kühlschranks → obsah ledničky
			der Austausch der Informationen → výměna informací
			die Zentrale → centrála
			der Adressat \[pl. -en\] → příjemce (dopisu, zprávy)
			Drei große Bilder an der Wand fallen sofort auf. → Tři velké obrazy (jsou hned nápadné)/(bijí do očí).
			bemerken → všimnout si
			die Atmosphäre → atmosféra
			Ich passe die Musik an meine Stimme an. → Přizpůsobím hudbu své náladě.
			die Geschwindigkeit des Fließbands steuern → řídit rychlost běžícího pásu
			das Gehalt \[pl. ä-er\] → plat
			Ich bin beeindruckt. → Udělalo to na mě dojem. \ Jsem ohromen.
			die Werbung → reklama
			die Werbeanzeige \[pl. -n\] → reklamní inzerát
			die Beschleunigung → zrychlení
			geschmacklos → nevkusný
			das Papiertaschentuch/Tempo \[pl. ü-er/-s\] → papírový kapesníček
			das Klebefilm \[pl. -e\] → lepící páska
			der Süßstoff → sladidlo
		}
		15.6. - XV {
			Konsum fördern → podporovat konzumismus
			der Trick \[pl. -s\] → trik
			die Branche \[pl. -n\] → (průmyslové) odvětví
			Das spricht mich nicht an. → To mě neoslovuje.
			der Genuss → požitek
			der Reime \[pl. -e\] → rým
			der Slogan \[pl. -s\] → slogan
			Emotionen wecken → vzbudit emoce
			das Kaufverhalten steuern → řídit nákupní chování
			in Erinnerung bleiben → zůstat ve vzpomínkách
			schmelzen \[3.     schmilzt
prät. schmolz
part. ist geschmolzen\] → tát \ rozpustit se
			der Ingwer → zázvor
			das Feld \[pl. -er\] → pole
			das Dach \[pl. ä-er\] → střecha
			der Ventilator \[pl. -en\] → větrák
			der Besitzer → vlastník
			die Neuerung → novinka/novota
			die Disziplin → kázeň/disciplína
			die Bedingung → podmínka
			die Arbeitskraft \[pl. ä-e\] → pracovní síla
		}
	}
	27. 100 §{
		15.6. - XVI {
			berufstätig/arbeitstätig/erwerbstätig → zaměstnaný
			alleinerziehend → samoživitelský
			die Erziehung → výchova
			autoritär → autoritářský
			sich stark\/wenig verändern → změnit se hodně\/málo
			im Gegensatz zu heute → oproti dnešku
			im Vergleich zu früher → v porovnání s dřívějškem
			der Wendepunkt → (zlomový bod)/(bod obratu)
			scheinbar → zdánlivý
			der Unfall → nehoda
			die Trennung → rozchod
			der Todesfall → úmrtí
			die Krise → krize
			der Prozess → proces
			der Lebenswandel → způsob života
			gelähmt → ochrnutý
			das Motto → motto
			das Skirennen → lyžařský závod
			die Wirbelsäule → páteř
			sich den Arm brechen → zlomit si ruku/paži
		}
		15.6. - XVII {
			der Bauchnabel → pupík
			der Redakteur \[pl. -e\] → redaktor
			der Willen → vůle
			überwinden \[prät. überwand
part. überwunden\] → překonat
			der Rollstuhl → vozíček
			der Therapeut \[pl. -en\] → terapeut
			vermitteln → zprostředkovat
			Angst abbauen → odbourat strach
			die Passivität → pasivita
			eine Firma übernehmen → převzít firmu
			die Massenproduktion → sériová výroba
			die Landwirtschaft → zemědělství
			tatsächlich → skutečně
			kostbar → drahocenný/vzácný
			wertvoll → hodnotný
			beweisen → dokázat/prokázat
			die Übungssache → otázka cviku
			die Einführung zu → úvod do
			der Umzug → stěhování \ průvod
			die Freundschaft → přátelství
		}
		15.6. - XVIII {
			das Dilemma \[pl. -s/-ta\] → dilema
			der Zweifel → pochyba/pochybnost
			die Wende → obrat/změna
			eine Mauer errichten → zřídit/postavit zeď
			fliehen → uprchnout
			der Versuch \[pl. -e\] → pokus
			für Kaffee anstehen → stát v řadě na kávu
			erfahren → dozvědět se
			erleben → zažít/prožít
			Gesagt, getan! → Jak se řeklo, tak se udělalo!
			ausgestattet → vybaven
			der Grenzübergang → hraniční přechod
			Dort strömten uns Menschenmassen entgegen. → Tam proti nám proudily masy lidí.
			jubeln → jásat
			grandios → velkolepý
			klopfen → klepat
			wildfremd → úplně cizí
			das Ereignis → událost
			vergleichbar → srovnatelný
			der Stolz → pýcha
		}
		15.6. - XIX {
			freie Wahlen fordern → požadovat svobodné volby
			die Vereinigung → sjednocení
			stolz → pyšný
			die Markwirtschaft → tržní hospodářství
			die Meinungsfreiheit → svoboda projevu/názoru
			der Konsum → spotřeba
			die Reisefreiheit → svoboda cestování
			staatlich → státní
			die Pressefreiheit → svoboda tisku
			der Kapitalismus → kapitalismus
			der Soldat \[pl. -en\] → voják
			jemanden im Stich lassen → nechat někoho (na holičkách)/(ve štichu)
			bei jedem Wetter arbeiten → pracovat při každém počasí
			Metall bearbeiten → zpracovávat kov
			die Analyse → analýza/rozbor
			geregelte Arbeitszeiten → řádná/pravidelná pracovní doba
			die Fremdsprachenkenntnisse → znalosti cizích jazyků
			die Elektronik → elektronika
			der Briefträger → listonoš
			der Wissenschaftler → vědec
		}
		7.9 I {
			das Leitungswasser → voda z kohoutku
			krumm → křivý
			gerade → rovný
			die Achterbahn → horská dráha
			geregelte Arbeitszeiten → pravidelná/pevná pracovní doba
			die Briefträgerin → pošťačka
			der Chemiker → chemik
			bei jedem Wetter draußen arbeiten → pracovat venku za každého počasí
			selbstständig → samostatný
			die Herausforderung → výzva
			Ich mache gleich mal Schluss. → Za chvíli končím.
			dringend → nutně
			die Besprechung → porada
			sich mit Essen bekleckern → pokecat se jídlem
			ansprechen → oslovit
			Cola über die Tastatur schütten → rozlít kolu na klávesnici
			Entschuldigung/Verzeihung/(Entschuldigen/Verzeihen Sie)! → Promiňte!
			Das war keine Absicht. → (To nebyl úmysl.)/(To nebylo naschvál.)
			unangenehm → nepříjemný
			Reden wir nicht mehr davon. → Už o tom nebudeme mluvit.
		}
	}
	7.9. II {
		Das kann doch jedem passieren. → To se přece může stát každému.
		die Bewerbung → ucházení se o práci/místo
		Worauf kommt es an? → Na čem záleží?
		auf keinen Fall → v žádném případě
		sich unterscheiden von → odlišovat se od
		die Unterlagen \[Plural\] → podklady
		aussagekräftig → přesvědčivý/výmluvný
		das Bewerbungsschreiben → motivační dopis
		der Lebenslauf → životopis
		selbstverständlich/natürlich → přirozeně/samozřejmě
		der Personalchef → personalista
		die Bescheinigung → potvrzení/doklad
		zusammenfassen → shrnout
		(der Anhang)/(die Anlage/Beilage) → příloha (v mailu)
		der Bewerber → uchazeč
		denken an → myslet na
		nachdenken über → přemýšlet o
		such kümmern um → starat se o
		das (Bewerbungs/Vorstellungs)gespräch → pracovní pohovor
	}
	7.9. III {
		der Händler → obchodník
		gerecht → spravedlivý
		die Kenntnisse \[Plural\] → znalosti
		die Öffentlichkeit → veřejnost
		eine Entscheidung treffen → učinit rozhodnutí
		der Stadtteil → městská část
		der Schreiner → truhlář
		entspannt → uvolněný
		eine Sprache beherrschen → ovládat jazyk
		der Eindruck → dojem
		beeinflussen → ovlivnit
		vorsichtig → opatrně
		üblich → běžný
		das Seminar → seminář
		sich verabschieden → rozloučit se
		unterstützen → podporovat
		entfernt → vzdálený
		schiefgehen → nepodpořit/nezdařit se
		sich warm anziehen → teple se obléci
		die Bedingung → podmínka
	}
	29.9. {
		der Lohn → mzda
		das Gehalt → plat
		der Nachtportier → noční vrátný
		die Rechnung → účet/faktura
		verfassen/schreiben → sepsat/napsat
		langfrisstig → dlouhodobý
		Ich hätte noch eine Frage. → Měl bych ještě jednu otázku.
		die Homepage → domovská stránka
		Die Stelle ist noch nicht besetzt. → To místo ještě není obsazené.
		vorschlagen → navrhnout
		einen Termin vereinbaren → domluvit si schůzku
		der Bereich → oblast
	}
	1.10. {
		denken an → myslet na
		nachdenken über → přemýšlet o
		das Benehmen → chování
		klagen/(sich beschweren) über → stěžovat si na
		geschickt → šikovný
		gestalten → vytvářet/tvořit/utvořit
		erfolgreich → úspěšný
		Ich drücke dir die Daumen. → Držím ti palce.
		die Verabschiedung → rozloučení
		(erwerbs/berufs/arbeits)tätig → pracující
		die Erlaubnis → dovolení
		die/der Beamte → úředník
	}
	5.10. \[11. 100 + 7.9. II + 5.10.\] {
		das (Bewerbungs/Vorstellungs)gespräch → pohovor
		meistern → vystřihnout/(mistrovsky provést/vymyslet)
		zusammenstellen → dát dohromady
		der Erste eindruck → první dojem
		ordentlich → řádný
		die Branche → hospodářské odvětví
		der Wirtschaftszweig → hospodářské odvětví
		die Werbeagentur → reklamní agentura
		die Körperhaltung → držení těla
		sich benehmen → chovat se
		die Art/Weise → způsob
		verhindern → zabránit
		sich mit etwas auseinandersetzen → zabývat se něčím
		veröffentlichen → zveřejnit
		der Vertrag → smlouva
	}
	12.10. {
		umweltfreundlich → přívětivý k životnímu prostředí
		die Verpackung → obal
		sich erholen/entspannen/ausruhen → odpočinout si \ uvolnit se
		relaxen → uvolnit se
		der Transportweg → dopravní cesta
		der Müll/Abfall → odpad
		schützen → chránit
		die Umwelt → životní prostředí
		das Recycling → recyklace
		recyceln → recyklovat
		das (Lebens/Nahrungs)mittel → potravina
		verbrauchen → spotřebovat
		der Konsum/Verbrauch → spotřeba
		verspeisen → sníst
		der Marktanteil → tržní podíl
		der Mond → Měsíc
		die Bevölkerung → obyvatelstvo
		jährlich → ročně
		steigende Zahlen \[-end → -ící\] → stoupající čísla
		die Gebühr → poplatek
		die Müllabfuhr → odvoz odpadu
		die Mülltrennung → třídění odpadu
		insgesamt → celkově
		die Menge → množství
		das Gut → zboží
		der Güterzug → nákladní vlak
		ökologischer Fußabdruck → ekologická stopa
	}
	13.10. \[12. 100 + 13.10. + 12.10.\] {
		die Bettdecke → peřina
		die Büchse → plechovka
		der Essig → ocet
		übrig bleiben → zůstat
		das Hackfleisch → mleté maso
		die Tankstelle → benzínová pumpa
		die Zahnbürste → zubní kartáček
		die Zahnpaste → zubní pasta
		die Fläche → rozloha
		die richtige Wahl treffen → učinit správnou volbu
		die Badewanne → vana
		nötig/notwendig → nutné
		die Plastiktüte → sáček/igelitka
		die Stoffetasche → látková taška
		reißen → trhat
		der Geschirrspüler \[pl. -\] → myčka
		der Zeitraum → časový rámec/období
		das Treibhausgas \[pl. -e\] → skleníkový plyn
		Aus diesem Grund sind sie besser. → Z tohoto důvodu jsou lepší.
		efficient → účinný
		produzieren/herstellen/erzeugen → vyrábět
		das Erdöl → ropa
	}
	15.10. {
		umweltschädlich → nepříznivý k životnímu prostředí
		das Verhalten → chování
		die Nachhaltigkeit → udržitelnost
		sich widmen → věnovat se
		die Verantwortung → zodpovědnost
		die Wirtschaft → hospodářství
		Ich bin der Meinung, dass → Jsem toho názoru, že
		Meiner Meinung/Ansicht nach → Dle mého názoru
		Ich stehe auf dem Standpunkt, dass → Zastávám názor, že
		Ich bin davon überzeugt, dass → Jsem o tom přesvědčen, že
		Das stimmt meiner Meinung nach ... nicht. → To neodpovídá/nesedí mému názoru na ....
		Hier muss ich widersprechen. → Tady musím jít proti.
		Ich sehe das ganz anders. → Já to vidím úplně jinak.
		Nein, ganz im Gegenteil. → Ne, úplně naopak.
	}
}
